chợ sơn la	chợ sơn la
văn miếu xích đằng	văn miếu xích đằng
tháp dương long	tháp dương long
đền mẫu đồng đăng	đền mẫu đồng đăng
tour mạo hiểm núi langbiang tại lâm đồng	tour mạo hiểm núi langbiang tại lâm đồng
hòa bình	hòa bình
ladalat hotel	ladalat hotel
cua dai beach hotel hoi an	cua dai beach hotel hoi an
anami resort bình ba	anami resort bình ba
dong xuan market	dong xuan market
chùa sắc tứ tam bảo	chùa sắc tứ tam bảo
victoria hoi an beach resort & spa	victoria hoi an beach resort & spa
dong ha market	dong ha market
bánh mì sài gòn	bánh mì sài gòn
thảo cầm viên sài gòn	thảo cầm viên sài gòn
đền đuổm	đền đuổm
ho coc beach resort	ho coc beach resort
sofitel legend metropole hà nội	sofitel legend metropole hà nội
lễ hội đền trần thái bình	lễ hội đền trần thái bình
đền thờ hoàng mười	đền thờ hoàng mười
tour du lịch đà nẵng	tour du lịch đà nẵng
nhà hàng hoàng gia	nhà hàng hoàng gia
hanoi tirant hotel	hanoi tirant hotel
nha hang hoang gia	nha hang hoang gia
chợ sắt	chợ sắt
lễ hội đền bờ hòa bình	lễ hội đền bờ hòa bình
paradise dai lai resort	paradise dai lai resort
banyan tree lang co (huế)	banyan tree lang co (huế)
victoria phan thiet beach resort & spa	victoria phan thiet beach resort & spa
nhà thờ bác trạch	nhà thờ bác trạch
khách sạn petro thái bình	khách sạn petro thái bình
lăng khải định	lăng khải định
quán bánh đa cua bà cụ (hạ long)	quán bánh đa cua bà cụ (hạ long)
hà giang	hà giang
nhà hàng tân lập	nhà hàng tân lập
sa huỳnh resort	sa huỳnh resort
green mango restaurant (cát bà)	green mango restaurant (cát bà)
nhà hàng phố núi lạng sơn	nhà hàng phố núi lạng sơn
tây bộ	tây bộ
nhà hàng đại lải	nhà hàng đại lải
tour hà giang - mèo vạc - cao nguyên đá đồng văn	tour hà giang - mèo vạc - cao nguyên đá đồng văn
tour du lịch bình thuận	tour du lịch bình thuận
thác prenn	thác prenn
tour du lịch đồng nai	tour du lịch đồng nai
lễ hội đua bò bảy núi	lễ hội đua bò bảy núi
tour du lịch đảo nam du (kiên giang)	tour du lịch đảo nam du (kiên giang)
tour du lịch hòa bình	tour du lịch hòa bình
tour du lịch sapa - bắc hà	tour du lịch sapa - bắc hà
sân chim vàm hồ	sân chim vàm hồ
tour hà nội - hoàng thành thăng long	tour hà nội - hoàng thành thăng long
thịt trâu gác bếp hà giang	thịt trâu gác bếp hà giang
vườn quốc gia xuân sơn	vườn quốc gia xuân sơn
ancient hue garden houses restaurant	ancient hue garden houses restaurant
núi hồng lĩnh	núi hồng lĩnh
lễ hội bà triệu	lễ hội bà triệu
trần đại nghĩa	trần đại nghĩa
khu du lịch kỳ co	khu du lịch kỳ co
flc luxury resort vĩnh phúc	flc luxury resort vĩnh phúc
lẩu mắm châu đốc	lẩu mắm châu đốc
nguyễn an ninh	nguyễn an ninh
thịt dê ninh bình	thịt dê ninh bình
đảo tuần châu	đảo tuần châu
vùng tây bắc	vùng tây bắc
tour leo núi fansipan	tour leo núi fansipan
tour du lịch thành phố hồ chí minh	tour du lịch thành phố hồ chí minh
ham tien market	ham tien market
mường thanh luxury sông lam hotel	mường thanh luxury sông lam hotel
tour du lịch bà rịa - vũng tàu	tour du lịch bà rịa - vũng tàu
nhà hàng đại nam	nhà hàng đại nam
sóc trăng	sóc trăng
tour du lịch đền hùng - phú thọ	tour du lịch đền hùng - phú thọ
thánh địa mỹ sơn	thánh địa mỹ sơn
tour du lịch cồn phụng bến tre	tour du lịch cồn phụng bến tre
chùa cầu hội an	chùa cầu hội an
núi tà cú	núi tà cú
chợ vườn hoa	chợ vườn hoa
chùa linh ứng	chùa linh ứng
easy tiger hostel & restaurant	easy tiger hostel & restaurant
lễ hội hoa lư	lễ hội hoa lư
chợ bắc hà (lào cai)	chợ bắc hà (lào cai)
ram bánh mướt	ram bánh mướt
bánh bột lọc mỹ chánh	bánh bột lọc mỹ chánh
văn cao	văn cao
hồ ba bể	hồ ba bể
bến tre	bến tre
lăng nguyễn hữu thọ	lăng nguyễn hữu thọ
bánh tráng mắm ruốc ninh thuận	bánh tráng mắm ruốc ninh thuận
gà nướng bản đôn	gà nướng bản đôn
lễ hội ok om bok vĩnh long	lễ hội ok om bok vĩnh long
nhà hàng hương sen thái bình	nhà hàng hương sen thái bình
tô hiến thành	tô hiến thành
làng tranh đông hồ	làng tranh đông hồ
nhà hàng a quỳnh	nhà hàng a quỳnh
đền chử đồng tử	đền chử đồng tử
khu du lịch xẻo quýt	khu du lịch xẻo quýt
tour đà nẵng - bán đảo sơn trà	tour đà nẵng - bán đảo sơn trà
tour sa pa - fansipan	tour sa pa - fansipan
nhà hàng đảo ó	nhà hàng đảo ó
lễ hội yên tử	lễ hội yên tử
ancient town restaurant	ancient town restaurant
nam bộ	nam bộ
bún kèn kiên giang	bún kèn kiên giang
love market	love market
hồ lắk	hồ lắk
lăng phạm văn đồng tại quảng ngãi	lăng phạm văn đồng tại quảng ngãi
nguyễn phan chánh	nguyễn phan chánh
la residence hotel & spa (huế)	la residence hotel & spa (huế)
đền cuông	đền cuông
apricot hotel hanoi	apricot hotel hanoi
nhà hàng hương biển trà vinh	nhà hàng hương biển trà vinh
nhà hàng bãi xép	nhà hàng bãi xép
nhà hàng quán gió lạng sơn	nhà hàng quán gió lạng sơn
cầu rồng	cầu rồng
pullman vung tau	pullman vung tau
cổng trời	cổng trời
oxalis home	oxalis home
tour du lịch vịnh hạ long	tour du lịch vịnh hạ long
bánh cuốn cao bằng	bánh cuốn cao bằng
chày lập farmstay	chày lập farmstay
chùa tam thanh	chùa tam thanh
đền cổ mễ	đền cổ mễ
imperial hotel huế	imperial hotel huế
tour du lịch cô tô - quảng ninh	tour du lịch cô tô - quảng ninh
bánh cu đơ	bánh cu đơ
tour đà nẵng - ngũ hành sơn - cù lao chàm	tour đà nẵng - ngũ hành sơn - cù lao chàm
chợ bạc liêu	chợ bạc liêu
đền hạ	đền hạ
vinpearl discovery cửa hội	vinpearl discovery cửa hội
nguyễn văn nghi	nguyễn văn nghi
lễ hội mù cang chải	lễ hội mù cang chải
khách sạn đông á plaza	khách sạn đông á plaza
động ngườm ngao	động ngườm ngao
duc long gia lai hotel 1	duc long gia lai hotel 1
bùi hữu nghĩa	bùi hữu nghĩa
sá sùng quan lạn	sá sùng quan lạn
tour điện biên phủ	tour điện biên phủ
tour du lịch vũng tàu	tour du lịch vũng tàu
chợ hòn sơn	chợ hòn sơn
bãi cháy	bãi cháy
flc hạ long bay golf club & luxury resort	flc hạ long bay golf club & luxury resort
cơm cháy ninh bình	cơm cháy ninh bình
sò huyết đầm ô loan phú yên	sò huyết đầm ô loan phú yên
coto center homestay	coto center homestay
ba bể lake view homestay	ba bể lake view homestay
động sơn mộc hương	động sơn mộc hương
hang dơi	hang dơi
tour đà nẵng - hội an - bán đảo sơn trà	tour đà nẵng - hội an - bán đảo sơn trà
đảo lý sơn	đảo lý sơn
thiền viện trúc lâm tây thiên	thiền viện trúc lâm tây thiên
tour du lịch hải phòng	tour du lịch hải phòng
royal lotus hotel halong	royal lotus hotel halong
biển tân thành	biển tân thành
chùa vàm rây	chùa vàm rây
the reverie saigon	the reverie saigon
nhà hàng morning glory hội an	nhà hàng morning glory hội an
khách sạn phoenix bắc ninh	khách sạn phoenix bắc ninh
thịt trâu gác bếp điện biên	thịt trâu gác bếp điện biên
dak nong lodge resort	dak nong lodge resort
lễ hội gò tháp	lễ hội gò tháp
cong fu hotel	cong fu hotel
khu du lịch sinh thái thác mai	khu du lịch sinh thái thác mai
villa song saigon	villa song saigon
nhà hàng hải sản cửa nhượng	nhà hàng hải sản cửa nhượng
đèo hải vân	đèo hải vân
tour du lịch phú quốc 5 ngày 4 đêm	tour du lịch phú quốc 5 ngày 4 đêm
phạm văn đồng	phạm văn đồng
lễ hội đền đuổm	lễ hội đền đuổm
nam long plus hotel	nam long plus hotel
tour hòn sơn kiên giang	tour hòn sơn kiên giang
công viên đồng xanh	công viên đồng xanh
little faifo restaurant hội an	little faifo restaurant hội an
chày lập farmstay quảng bình	chày lập farmstay quảng bình
hòn tre	hòn tre
lễ hội dinh cậu kiên giang	lễ hội dinh cậu kiên giang
biển sầm sơn	biển sầm sơn
melia hanoi	melia hanoi
phong nha farmstay	phong nha farmstay
chùa cổ lễ	chùa cổ lễ
mekong hotel	mekong hotel
nhà hàng sao hôm	nhà hàng sao hôm
quảng bình	quảng bình
tour du lịch long an	tour du lịch long an
nguyễn trãi	nguyễn trãi
tour du lịch sóc trăng	tour du lịch sóc trăng
chez loan tam coc restaurant	chez loan tam coc restaurant
muong thanh grand ha tinh hotel	muong thanh grand ha tinh hotel
lễ hội ok om bok	lễ hội ok om bok
trịnh hoài đức	trịnh hoài đức
lễ hội tháp bà ponagar	lễ hội tháp bà ponagar
chợ quảng ngãi	chợ quảng ngãi
khách sạn mường thanh hà nam	khách sạn mường thanh hà nam
ganh hao restaurant	ganh hao restaurant
bánh chưng bờ đậu	bánh chưng bờ đậu
ninh binh hidden charm hotel & resort	ninh binh hidden charm hotel & resort
chợ hậu giang	chợ hậu giang
dalat palace heritage hotel	dalat palace heritage hotel
tour du lịch tràng an - tam cốc	tour du lịch tràng an - tam cốc
thành cổ quảng trị	thành cổ quảng trị
công viên đồi dương	công viên đồi dương
tháp nhạn	tháp nhạn
lễ hội dừa bến tre	lễ hội dừa bến tre
pizza 4p's saigon	pizza 4p's saigon
công viên thống nhất	công viên thống nhất
nhà hàng yến nha trang	nhà hàng yến nha trang
tour du lịch gia lai	tour du lịch gia lai
easy tiger hostel quảng bình	easy tiger hostel quảng bình
cao bằng	cao bằng
bún nước lèo	bún nước lèo
đài tưởng niệm nguyễn văn tố tại hà nội	đài tưởng niệm nguyễn văn tố tại hà nội
allegro hoi an - little luxury hotel & spa	allegro hoi an - little luxury hotel & spa
hồ tà đùng	hồ tà đùng
tour du lịch bình dương	tour du lịch bình dương
stelia beach resort	stelia beach resort
fusion maia resort danang	fusion maia resort danang
chùa ba vàng	chùa ba vàng
nhà hàng hoàng hôn	nhà hàng hoàng hôn
lào cai	lào cai
lễ hội chùa vĩnh nghiêm	lễ hội chùa vĩnh nghiêm
thanh hóa	thanh hóa
léman cap resort & spa	léman cap resort & spa
biển hồ	biển hồ
bãi biển quy nhơn	bãi biển quy nhơn
nhà hàng năm hiền đà nẵng	nhà hàng năm hiền đà nẵng
ninh thuan retreat resort ninh thuận	ninh thuan retreat resort ninh thuận
ninh binh legend hotel	ninh binh legend hotel
nhà hàng làng biển quảng ngãi	nhà hàng làng biển quảng ngãi
tam coc la montagne resort & spa	tam coc la montagne resort & spa
bảo tàng chăm	bảo tàng chăm
hòn sơn	hòn sơn
nhà hàng a1 điện biên	nhà hàng a1 điện biên
chợ đồng xoài	chợ đồng xoài
cocobay danang	cocobay danang
tháp chàm poshanư	tháp chàm poshanư
hilton hanoi opera	hilton hanoi opera
nhà hàng cua vàng	nhà hàng cua vàng
tháp cánh tiên	tháp cánh tiên
resort mekong garden	resort mekong garden
nhà hàng cây xoài	nhà hàng cây xoài
nhà hàng biển xanh	nhà hàng biển xanh
bắc trung bộ	bắc trung bộ
quảng ninh	quảng ninh
trần văn trà	trần văn trà
biển cửa việt	biển cửa việt
tung homestay quảng bình	tung homestay quảng bình
núi hàm rồng	núi hàm rồng
lễ hội kỳ yên vĩnh long	lễ hội kỳ yên vĩnh long
nhà hàng cây bàng sóc trăng	nhà hàng cây bàng sóc trăng
tour sa pa - cát cát	tour sa pa - cát cát
chợ gạo hưng yên	chợ gạo hưng yên
phở hà nội	phở hà nội
nhà hàng surf bar - quy nhơn	nhà hàng surf bar - quy nhơn
tour du lịch thung nai hòa bình	tour du lịch thung nai hòa bình
bánh nếp nhân trứng kiến	bánh nếp nhân trứng kiến
bảo tàng chiến thắng điện biên phủ	bảo tàng chiến thắng điện biên phủ
chùa ông	chùa ông
nhà hàng nổi bến tre	nhà hàng nổi bến tre
bánh canh trảng bàng	bánh canh trảng bàng
salinda resort phú quốc	salinda resort phú quốc
đền trần thương	đền trần thương
wyndham legend halong hotel	wyndham legend halong hotel
nhà hàng tân sơn nhất đắk nông	nhà hàng tân sơn nhất đắk nông
tà đùng lake view homestay	tà đùng lake view homestay
intercontinental nha trang	intercontinental nha trang
tour hạ long - bãi cháy	tour hạ long - bãi cháy
khách sạn mường thanh luxury hà nam	khách sạn mường thanh luxury hà nam
đầm ô loan	đầm ô loan
phong nha bamboo cafe quảng bình	phong nha bamboo cafe quảng bình
tour chinh phục đỉnh fansipan	tour chinh phục đỉnh fansipan
siêu thị co.opmart ninh thuận	siêu thị co.opmart ninh thuận
lăng phan thanh giản tại bến tre	lăng phan thanh giản tại bến tre
eva cafe kon tum	eva cafe kon tum
bánh gio bắc kạn	bánh gio bắc kạn
nậm pịa	nậm pịa
tour hạ long - yên tử	tour hạ long - yên tử
thác giang điền	thác giang điền
vịnh vĩnh hy	vịnh vĩnh hy
chùa thiên hưng	chùa thiên hưng
tre nguon resort	tre nguon resort
đền thờ nguyễn xí	đền thờ nguyễn xí
tour du lịch mai châu - hòa bình	tour du lịch mai châu - hòa bình
tour du lịch trà vinh	tour du lịch trà vinh
vincom plaza hà nam	vincom plaza hà nam
núi dành	núi dành
chợ lai châu	chợ lai châu
bánh tráng cuốn thịt heo đà nẵng	bánh tráng cuốn thịt heo đà nẵng
tam coc rice fields resort	tam coc rice fields resort
hoi an central market	hoi an central market
long hai market	long hai market
công viên 23 tháng 9	công viên 23 tháng 9
vincom plaza (đà nẵng)	vincom plaza (đà nẵng)
cá hồi sapa	cá hồi sapa
gỏi cuốn sài gòn	gỏi cuốn sài gòn
hanoi la siesta hotel & spa	hanoi la siesta hotel & spa
nhà hàng hải sản bé mặn đà nẵng	nhà hàng hải sản bé mặn đà nẵng
lăng minh mạng	lăng minh mạng
đảo bình hưng	đảo bình hưng
thịt trâu gác bếp	thịt trâu gác bếp
la siesta central hotel & spa	la siesta central hotel & spa
tour du lịch an giang	tour du lịch an giang
vùng duyên hải nam trung bộ	vùng duyên hải nam trung bộ
bánh canh hẹ phú yên	bánh canh hẹ phú yên
lan rừng resort & spa long hải	lan rừng resort & spa long hải
belvedere resort tam đảo	belvedere resort tam đảo
nhà hàng hương quê	nhà hàng hương quê
resort đảo ó	resort đảo ó
lễ hội nghinh ông quan thánh đế quân	lễ hội nghinh ông quan thánh đế quân
phở khô gia lai	phở khô gia lai
lễ hội đua thuyền truyền thống quảng ngãi	lễ hội đua thuyền truyền thống quảng ngãi
chợ bình ba	chợ bình ba
tour du lịch bình định	tour du lịch bình định
lễ hội nghinh ông	lễ hội nghinh ông
coto lodge mini hotel	coto lodge mini hotel
nhà hàng red dao house sapa	nhà hàng red dao house sapa
resort hậu giang	resort hậu giang
tour miền tây sông nước	tour miền tây sông nước
lễ hội bà thu bồn	lễ hội bà thu bồn
aeon mall hải phòng lê chân	aeon mall hải phòng lê chân
chợ đêm sapa	chợ đêm sapa
vinpearl hotel imperia hải phòng	vinpearl hotel imperia hải phòng
tour quảng trị	tour quảng trị
hoi an ancient house village resort and spa	hoi an ancient house village resort and spa
hầm hô	hầm hô
phong nha farmstay quảng bình	phong nha farmstay quảng bình
đền thờ đức thánh trần hưng đạo	đền thờ đức thánh trần hưng đạo
chùa tiên châu	chùa tiên châu
nhà hàng cá hồi vườn đào	nhà hàng cá hồi vườn đào
tour đà nẵng - hội an	tour đà nẵng - hội an
đắk lắk	đắk lắk
hotel majestic sài gòn	hotel majestic sài gòn
tour tham quan thành phố hồ chí minh	tour tham quan thành phố hồ chí minh
khách sạn dakruco	khách sạn dakruco
chùa âng	chùa âng
sao hom restaurant (can tho)	sao hom restaurant (can tho)
hà tĩnh	hà tĩnh
gỏi lá kon tum	gỏi lá kon tum
jw marriott hotel hanoi	jw marriott hotel hanoi
kon tum market	kon tum market
núi chúa	núi chúa
joe's cafe mui ne	joe's cafe mui ne
thác phú cường	thác phú cường
bình phước	bình phước
khách sạn cao nguyên đá	khách sạn cao nguyên đá
công viên bãi sau	công viên bãi sau
nam bo boutique hotel	nam bo boutique hotel
công viên thành phố mới bình dương	công viên thành phố mới bình dương
thiền viện trúc lâm đà lạt	thiền viện trúc lâm đà lạt
sài gòn - phú thọ hotel	sài gòn - phú thọ hotel
lễ hội đền hùng vĩnh phúc	lễ hội đền hùng vĩnh phúc
công viên lưu hữu phước	công viên lưu hữu phước
lễ hội katê	lễ hội katê
bánh gai tứ trụ	bánh gai tứ trụ
chợ tân lập	chợ tân lập
terracotta hotel & resort dalat	terracotta hotel & resort dalat
nguyễn chí thanh	nguyễn chí thanh
pilgrimage village boutique resort & spa huế	pilgrimage village boutique resort & spa huế
khách sạn đồ sơn	khách sạn đồ sơn
chợ cồn đà nẵng	chợ cồn đà nẵng
nha hang sen vang	nha hang sen vang
vincom plaza đà nẵng	vincom plaza đà nẵng
chợ đọ bắc ninh	chợ đọ bắc ninh
tháp bình sơn	tháp bình sơn
easy tiger hostel	easy tiger hostel
hotel royal hoi an	hotel royal hoi an
khách sạn long an	khách sạn long an
bánh căn bình thuận	bánh căn bình thuận
tour khám phá đảo lý sơn	tour khám phá đảo lý sơn
anami resort	anami resort
tràng an	tràng an
khách sạn mường thanh điện biên phủ	khách sạn mường thanh điện biên phủ
vùng tây nguyên	vùng tây nguyên
tour du lịch núi chúa ninh thuận	tour du lịch núi chúa ninh thuận
nhà hàng phố hiến	nhà hàng phố hiến
bạch đằng giang	bạch đằng giang
bb hotel sapa	bb hotel sapa
sailing club phu quoc	sailing club phu quoc
tour du lịch tây bắc	tour du lịch tây bắc
hà giang market	hà giang market
bánh nẳng	bánh nẳng
hanoi la siesta premium hang be	hanoi la siesta premium hang be
anantara hoi an resort	anantara hoi an resort
lễ hội đua voi bù đăng	lễ hội đua voi bù đăng
tour phong nha - kẻ bàng	tour phong nha - kẻ bàng
khách sạn bình ba	khách sạn bình ba
lễ hội nghinh ông kiên giang	lễ hội nghinh ông kiên giang
suối nước nóng u va	suối nước nóng u va
mai châu	mai châu
tour du lịch bắc ninh	tour du lịch bắc ninh
nhà hàng sen tây hồ	nhà hàng sen tây hồ
nhà hàng bàu sen	nhà hàng bàu sen
mango mango restaurant	mango mango restaurant
flc luxury resort quy nhơn	flc luxury resort quy nhơn
melia ho tram beach resort	melia ho tram beach resort
coto garden	coto garden
victoria sapa resort & spa	victoria sapa resort & spa
hanoi street food restaurant	hanoi street food restaurant
pleiku night market	pleiku night market
suối nước nóng hua pe	suối nước nóng hua pe
biển hồ tràm	biển hồ tràm
khu du lịch ma thiên lãnh	khu du lịch ma thiên lãnh
lễ hội đền hạ	lễ hội đền hạ
lẩu cá lăng đắk lắk	lẩu cá lăng đắk lắk
pandanus resort	pandanus resort
khách sạn mường thanh lai châu	khách sạn mường thanh lai châu
lễ hội kỳ yên hậu giang	lễ hội kỳ yên hậu giang
nhà máy thủy điện hòa bình	nhà máy thủy điện hòa bình
gà nướng plei ku	gà nướng plei ku
đại nội huế	đại nội huế
động nhị thanh	động nhị thanh
đảo bình ba	đảo bình ba
nhà hàng hòn sơn	nhà hàng hòn sơn
bảo tàng đắk lắk	bảo tàng đắk lắk
ngã ba đồng lộc	ngã ba đồng lộc
gành hào restaurant vũng tàu	gành hào restaurant vũng tàu
sơn nam	sơn nam
tour du lịch nam định	tour du lịch nam định
bánh tét lá cẩm hậu giang	bánh tét lá cẩm hậu giang
chợ phan rang ninh thuận	chợ phan rang ninh thuận
tour du lịch tam cốc - bích động	tour du lịch tam cốc - bích động
nhà hàng mekong rest stop	nhà hàng mekong rest stop
lễ hội tịch điền đọi sơn	lễ hội tịch điền đọi sơn
chợ mường thanh	chợ mường thanh
đền thờ nguyễn duy hiệu tại quảng nam	đền thờ nguyễn duy hiệu tại quảng nam
suối cá thần cẩm lương	suối cá thần cẩm lương
khách sạn victoria sapa resort & spa	khách sạn victoria sapa resort & spa
đền thờ trần hưng đạo	đền thờ trần hưng đạo
khách sạn sunny cao bằng	khách sạn sunny cao bằng
thác đray sáp	thác đray sáp
nhà hàng chả cá lã vọng hà nội	nhà hàng chả cá lã vọng hà nội
nha trang center	nha trang center
four seasons resort the nam hai hội an	four seasons resort the nam hai hội an
nhà hàng quán ăn ngon hà nội	nhà hàng quán ăn ngon hà nội
giỗ tổ hùng vương	giỗ tổ hùng vương
bánh cáy thái bình	bánh cáy thái bình
lễ hội đền hùng đồng nai	lễ hội đền hùng đồng nai
resort sun spa quảng bình	resort sun spa quảng bình
lẩu mắm u minh	lẩu mắm u minh
gành hào restaurant	gành hào restaurant
bánh cống sóc trăng	bánh cống sóc trăng
biển long hải	biển long hải
vinpearl resort nha trang	vinpearl resort nha trang
lợn quay lạng sơn	lợn quay lạng sơn
vinpearl resort & spa đà nẵng	vinpearl resort & spa đà nẵng
vinpearl luxury landmark 81	vinpearl luxury landmark 81
tour hà nội - chùa quán sứ	tour hà nội - chùa quán sứ
bánh tráng mỹ lồng	bánh tráng mỹ lồng
hanoi la siesta premium ma may	hanoi la siesta premium ma may
siêu thị coopmart hậu giang	siêu thị coopmart hậu giang
chùa nôm	chùa nôm
muong thanh quang tri hotel	muong thanh quang tri hotel
khách sạn đồi dương	khách sạn đồi dương
flamingo cat ba beach resort	flamingo cat ba beach resort
đinh tiên hoàng	đinh tiên hoàng
tam coc garden resort	tam coc garden resort
đền thờ nguyễn văn cừ (bắc ninh)	đền thờ nguyễn văn cừ (bắc ninh)
cơm tấm sài gòn	cơm tấm sài gòn
bãi sau	bãi sau
lê lợi	lê lợi
lotte mart đà nẵng	lotte mart đà nẵng
vườn quốc gia phong nha-kẻ bàng	vườn quốc gia phong nha-kẻ bàng
vincom plaza hà tĩnh	vincom plaza hà tĩnh
nhà hàng phố núi	nhà hàng phố núi
chả cá lã vọng	chả cá lã vọng
bánh canh chả cá	bánh canh chả cá
ancient hue garden houses	ancient hue garden houses
cai rang floating market	cai rang floating market
ngán quảng ninh	ngán quảng ninh
nhà hàng vườn xoài bắc ninh	nhà hàng vườn xoài bắc ninh
điện biên	điện biên
việt nam	việt nam
đền thờ lý nhật quang	đền thờ lý nhật quang
hàu long sơn	hàu long sơn
konklor hotel kon tum	konklor hotel kon tum
lẩu mắm cần thơ	lẩu mắm cần thơ
văn thánh miếu vĩnh long	văn thánh miếu vĩnh long
tour miền trung	tour miền trung
đồi a1	đồi a1
nguyễn bá thanh	nguyễn bá thanh
bún cá long xuyên	bún cá long xuyên
bánh hòn	bánh hòn
bánh tét long an	bánh tét long an
morning glory restaurant hội an	morning glory restaurant hội an
tour hà nội city 1 ngày	tour hà nội city 1 ngày
bắc kạn	bắc kạn
nhà hàng madame lân	nhà hàng madame lân
chợ đồng xuân hà nội	chợ đồng xuân hà nội
tour khám phá thành phố hồ chí minh	tour khám phá thành phố hồ chí minh
lăng mộ phan châu trinh tại đà nẵng	lăng mộ phan châu trinh tại đà nẵng
lễ hội pôồn pôông	lễ hội pôồn pôông
hanoi meracus hotel 1	hanoi meracus hotel 1
lúa nếp restaurant	lúa nếp restaurant
núi pắc tạ	núi pắc tạ
nem chợ huyện	nem chợ huyện
bánh tráng phơi sương tây ninh	bánh tráng phơi sương tây ninh
on the rocks restaurant	on the rocks restaurant
làng cà phê trung nguyên	làng cà phê trung nguyên
khách sạn dragon sea sầm sơn	khách sạn dragon sea sầm sơn
cao văn lầu	cao văn lầu
động puông	động puông
cua vàng restaurant	cua vàng restaurant
vải thiều lục ngạn	vải thiều lục ngạn
đền mẫu âu cơ	đền mẫu âu cơ
nguyễn hữu thọ	nguyễn hữu thọ
tour khám phá đảo bình hưng	tour khám phá đảo bình hưng
hanoi imperial hotel	hanoi imperial hotel
bánh khọt vũng tàu	bánh khọt vũng tàu
tour khám phá vườn quốc gia núi chúa	tour khám phá vườn quốc gia núi chúa
chả mực hạ long	chả mực hạ long
bảo tàng quang trung	bảo tàng quang trung
chợ đầm nha trang	chợ đầm nha trang
nhà hàng thác bà	nhà hàng thác bà
bún nước lèo sóc trăng	bún nước lèo sóc trăng
mekong lodge resort	mekong lodge resort
đèo ô quy hồ	đèo ô quy hồ
vùng đông nam bộ	vùng đông nam bộ
vùng bắc trung bộ	vùng bắc trung bộ
bãi trước	bãi trước
nhà hàng nhà gỗ	nhà hàng nhà gỗ
vườn hoa đà lạt	vườn hoa đà lạt
tour du lịch cồn quy bến tre	tour du lịch cồn quy bến tre
vườn quốc gia u minh thượng	vườn quốc gia u minh thượng
hoàng văn thụ	hoàng văn thụ
hue riverside boutique resort & spa	hue riverside boutique resort & spa
nhà hàng hương sen	nhà hàng hương sen
nhà hàng quảng trị	nhà hàng quảng trị
pleiku market	pleiku market
vincom plaza việt trì	vincom plaza việt trì
tour du lịch yên tử - quảng ninh	tour du lịch yên tử - quảng ninh
nhà hàng nổi cồn phụng	nhà hàng nổi cồn phụng
chợ rồng nam định	chợ rồng nam định
thành phố hồ chí minh	thành phố hồ chí minh
novotel phu quoc resort	novotel phu quoc resort
dinh cau night market	dinh cau night market
vườn quốc gia xuân thủy	vườn quốc gia xuân thủy
resort le champ tú lệ	resort le champ tú lệ
sun spa resort	sun spa resort
công viên bãi trước	công viên bãi trước
tour du lịch long hải - vũng tàu	tour du lịch long hải - vũng tàu
nhà hàng quán ăn ngon	nhà hàng quán ăn ngon
tháp đôi	tháp đôi
nem lai vung	nem lai vung
nguyễn văn huyên	nguyễn văn huyên
chùa quán sứ	chùa quán sứ
nhà hàng hương biển	nhà hàng hương biển
essence hanoi hotel & spa	essence hanoi hotel & spa
rex hotel saigon	rex hotel saigon
bún chả cá quy nhơn	bún chả cá quy nhơn
an lam retreats ninh van bay	an lam retreats ninh van bay
hạ long market	hạ long market
đài tưởng niệm hoàng văn thụ	đài tưởng niệm hoàng văn thụ
chợ vũng tàu	chợ vũng tàu
hyatt regency danang resort and spa	hyatt regency danang resort and spa
thác dải yếm	thác dải yếm
tour chinh phục đỉnh pu ta leng	tour chinh phục đỉnh pu ta leng
lễ hội thành bản phủ	lễ hội thành bản phủ
cát bà island resort & spa	cát bà island resort & spa
cao nguyen restaurant	cao nguyen restaurant
bac ha boutique homestay	bac ha boutique homestay
cầu kính rồng mây	cầu kính rồng mây
tour tuyên quang	tour tuyên quang
tour khám phá hang sơn đoòng	tour khám phá hang sơn đoòng
khu du lịch sinh thái gáo giồng	khu du lịch sinh thái gáo giồng
vườn quốc gia chư mom ray	vườn quốc gia chư mom ray
cầu hiền lương	cầu hiền lương
bánh quai vạc bình thuận	bánh quai vạc bình thuận
lễ hội đường phố kon tum	lễ hội đường phố kon tum
vincom plaza tây ninh	vincom plaza tây ninh
tour du lịch hà nội - hạ long	tour du lịch hà nội - hạ long
tour khánh hòa	tour khánh hòa
đền thác bờ	đền thác bờ
động hua mạ	động hua mạ
nông văn vân	nông văn vân
pa pỉnh tộp điện biên	pa pỉnh tộp điện biên
amanoi resort	amanoi resort
chợ thung nai	chợ thung nai
chế lan viên	chế lan viên
resort suối mơ đồng nai	resort suối mơ đồng nai
big c quy nhơn	big c quy nhơn
chapa dew boutique hotel	chapa dew boutique hotel
bãi biển mũi né	bãi biển mũi né
khách sạn sài gòn bạc liêu	khách sạn sài gòn bạc liêu
núi thần đinh	núi thần đinh
vườn quốc gia u minh hạ	vườn quốc gia u minh hạ
tour sapa - fansipan	tour sapa - fansipan
hà nam	hà nam
chùa tôn thạnh	chùa tôn thạnh
tour du lịch hậu giang	tour du lịch hậu giang
saigon centre	saigon centre
resort mai châu ecolodge	resort mai châu ecolodge
ba be green homestay	ba be green homestay
bãi biển mỹ khê	bãi biển mỹ khê
the cliff resort & residences mũi né	the cliff resort & residences mũi né
lễ hội bạch đằng	lễ hội bạch đằng
bà rịa - vũng tàu	bà rịa - vũng tàu
nhà hàng vị hoàng	nhà hàng vị hoàng
resort suối mơ	resort suối mơ
fusion resort phu quoc	fusion resort phu quoc
tour mạo hiểm hang sơn đoòng	tour mạo hiểm hang sơn đoòng
thác cam ly	thác cam ly
đền thờ nguyễn thị minh khai (hà nội)	đền thờ nguyễn thị minh khai (hà nội)
quảng trị	quảng trị
vườn quốc gia yok đôn	vườn quốc gia yok đôn
lễ hội sông đà rằng	lễ hội sông đà rằng
the shells resort & spa phu quoc	the shells resort & spa phu quoc
bảo tàng chứng tích chiến tranh	bảo tàng chứng tích chiến tranh
ngũ hành sơn	ngũ hành sơn
tour khám phá hang động chư bluk tại đắk nông	tour khám phá hang động chư bluk tại đắk nông
trương định	trương định
saigon square	saigon square
bản lác	bản lác
nhà hàng a phủ sapa	nhà hàng a phủ sapa
nhà hàng quán cơm tấm	nhà hàng quán cơm tấm
green bamboo lodge resort	green bamboo lodge resort
the deck saigon	the deck saigon
lễ hội đình thần nguyễn trung trực kiên giang	lễ hội đình thần nguyễn trung trực kiên giang
pullman danang beach resort	pullman danang beach resort
ba le market	ba le market
h'hen niê	h'hen niê
long xuyen market	long xuyen market
resort mộc châu arena village	resort mộc châu arena village
chùa vĩnh tràng	chùa vĩnh tràng
vinpearl land nha trang	vinpearl land nha trang
bánh bèo phú yên	bánh bèo phú yên
nhà hàng cơm mậu	nhà hàng cơm mậu
nguyễn khắc nhu	nguyễn khắc nhu
lễ hội gầu tào	lễ hội gầu tào
bánh khoái	bánh khoái
ninh thuận market	ninh thuận market
thung nai	thung nai
bánh xèo ninh thuận	bánh xèo ninh thuận
my tho market	my tho market
chợ long an	chợ long an
vincom plaza tuyen quang	vincom plaza tuyen quang
banyan tree lăng cô resort	banyan tree lăng cô resort
mekong long xuyên hotel	mekong long xuyên hotel
phong nha lake house resort	phong nha lake house resort
tour du lịch huế	tour du lịch huế
cầu treo kon klor	cầu treo kon klor
chùa sắc tứ khải đoan	chùa sắc tứ khải đoan
tour du lịch thái bình	tour du lịch thái bình
đảo cô tô	đảo cô tô
chez loan hotel	chez loan hotel
saigon-ninh chu hotel & resort ninh thuận	saigon-ninh chu hotel & resort ninh thuận
nhà hàng mekong	nhà hàng mekong
phoenix hotel hà giang	phoenix hotel hà giang
chợ đông kinh	chợ đông kinh
địa đạo củ chi	địa đạo củ chi
sa đéc market	sa đéc market
hanoi elegance ruby hotel	hanoi elegance ruby hotel
nhà hàng song mây	nhà hàng song mây
công viên xà no	công viên xà no
hoàng vũ biển hồ resort	hoàng vũ biển hồ resort
đầm thị tường	đầm thị tường
tháp po klong garai	tháp po klong garai
cát tiên national park restaurant	cát tiên national park restaurant
đền thờ nguyễn văn đọc tại quảng ninh	đền thờ nguyễn văn đọc tại quảng ninh
phở bò nam định	phở bò nam định
khách sạn mường thanh cửa lò	khách sạn mường thanh cửa lò
forest floor lodge	forest floor lodge
lạng sơn	lạng sơn
lan rừng resort & spa	lan rừng resort & spa
khu di tích tân trào	khu di tích tân trào
little hoi an boutique hotel & spa	little hoi an boutique hotel & spa
nhà hàng phương nam lai châu	nhà hàng phương nam lai châu
biển lăng cô	biển lăng cô
núi sam	núi sam
quang dũng	quang dũng
chợ buôn ma thuột	chợ buôn ma thuột
lễ hội đền đô	lễ hội đền đô
cốm làng vòng	cốm làng vòng
nhà hàng quán ốc đêm	nhà hàng quán ốc đêm
lotte mart vũng tàu	lotte mart vũng tàu
hanoi old quarter hotel	hanoi old quarter hotel
mekong riverside boutique resort & spa	mekong riverside boutique resort & spa
thịt chua thanh sơn	thịt chua thanh sơn
vịt quay 7 vị cao bằng	vịt quay 7 vị cao bằng
gỏi cá biên hòa	gỏi cá biên hòa
bánh xèo đà nẵng	bánh xèo đà nẵng
nhà hàng dân tộc mai châu	nhà hàng dân tộc mai châu
đảo phú quốc	đảo phú quốc
bãi biển nhật lệ	bãi biển nhật lệ
làng vườn bách thuận	làng vườn bách thuận
chợ phiên đồng văn (hà giang)	chợ phiên đồng văn (hà giang)
bánh ít lá gai	bánh ít lá gai
nguyễn huệ	nguyễn huệ
thành nhà mạc	thành nhà mạc
nhà hàng nổi mỹ tho	nhà hàng nổi mỹ tho
mai chau ecolodge	mai chau ecolodge
khu di tích xẻo quýt	khu di tích xẻo quýt
six senses côn đảo	six senses côn đảo
tour du lịch hưng yên	tour du lịch hưng yên
tour huế - đà nẵng - hội an	tour huế - đà nẵng - hội an
nha hang hoang anh gia lai	nha hang hoang anh gia lai
lợn cắp nách lai châu	lợn cắp nách lai châu
nhà hàng surf bar	nhà hàng surf bar
chợ mường lò	chợ mường lò
hải phòng	hải phòng
vincom plaza hoi an	vincom plaza hoi an
đền trần thái bình	đền trần thái bình
đền thờ an dương vương	đền thờ an dương vương
núi đôi quản bạ	núi đôi quản bạ
park hyatt saigon	park hyatt saigon
cà mau	cà mau
bánh gai đức thọ	bánh gai đức thọ
chợ sapa	chợ sapa
chùa keo	chùa keo
thắng cố hà giang	thắng cố hà giang
tour cà mau	tour cà mau
nhà hàng cơm niêu hội an - quy nhơn	nhà hàng cơm niêu hội an - quy nhơn
lễ hội chợ tình ba bể	lễ hội chợ tình ba bể
bánh bột lọc huế	bánh bột lọc huế
takashimaya vietnam	takashimaya vietnam
nhà hàng hải âu lý sơn	nhà hàng hải âu lý sơn
vịt quay lạng sơn	vịt quay lạng sơn
vịnh xuân đài	vịnh xuân đài
nhà hàng le rabelais	nhà hàng le rabelais
lễ hội đền cờn	lễ hội đền cờn
vedana lagoon resort & spa	vedana lagoon resort & spa
cua lo beach resort	cua lo beach resort
cánh đồng mường thanh	cánh đồng mường thanh
tour đà nẵng - bà nà - bán đảo sơn trà	tour đà nẵng - bà nà - bán đảo sơn trà
hủ tiếu sa đéc	hủ tiếu sa đéc
gành đá đĩa	gành đá đĩa
trần quý cáp	trần quý cáp
tour đà nẵng - huế - bà nà hills	tour đà nẵng - huế - bà nà hills
lan rung resort & spa long hai	lan rung resort & spa long hai
him lam resort	him lam resort
tour du lịch đà lạt	tour du lịch đà lạt
gà quay xôi phồng bình dương	gà quay xôi phồng bình dương
hồ thác bà	hồ thác bà
tháp bà ponagar	tháp bà ponagar
tre nguồn resort	tre nguồn resort
nguyễn đình chiểu	nguyễn đình chiểu
tour đà nẵng - ngũ hành sơn - hội an	tour đà nẵng - ngũ hành sơn - hội an
chợ phiên sapa	chợ phiên sapa
đền hùng	đền hùng
lễ hội vía bà ngũ hành	lễ hội vía bà ngũ hành
chợ mộc châu	chợ mộc châu
imperial hotel vũng tàu	imperial hotel vũng tàu
chợ đêm phú quốc	chợ đêm phú quốc
rau sắn phú thọ	rau sắn phú thọ
khách sạn ánh nguyệt	khách sạn ánh nguyệt
ba be national park resort	ba be national park resort
mai châu lodge	mai châu lodge
bún hến mai xá	bún hến mai xá
resort topas ecolodge	resort topas ecolodge
bánh canh chả cá long an	bánh canh chả cá long an
chợ phiên mộc châu	chợ phiên mộc châu
chợ đồng hới	chợ đồng hới
chợ trung tâm việt trì	chợ trung tâm việt trì
động am tiên	động am tiên
tour du lịch hồ tràm - vũng tàu	tour du lịch hồ tràm - vũng tàu
nam trung bộ	nam trung bộ
bánh coóc mò bắc kạn	bánh coóc mò bắc kạn
động tiên sơn	động tiên sơn
ninh chu bay beach club & hotel	ninh chu bay beach club & hotel
quảng ngãi	quảng ngãi
night market phu quoc	night market phu quoc
chợ đông ba huế	chợ đông ba huế
hồ dầu tiếng	hồ dầu tiếng
sala tuy hòa beach hotel	sala tuy hòa beach hotel
mai chau market	mai chau market
lăng nguyễn văn linh	lăng nguyễn văn linh
tuyen quang market	tuyen quang market
flamingo đại lải resort	flamingo đại lải resort
lễ hội chọi trâu đồ sơn	lễ hội chọi trâu đồ sơn
westlake hotel & resort vĩnh phúc	westlake hotel & resort vĩnh phúc
cồn phụng	cồn phụng
chùa long khánh	chùa long khánh
cần thơ	cần thơ
cái dăm market	cái dăm market
capture vietnam cafe	capture vietnam cafe
lễ hội rằm tháng giêng	lễ hội rằm tháng giêng
chả nướng chợ gạo	chả nướng chợ gạo
mia resort nha trang	mia resort nha trang
chùa bà chúa xứ	chùa bà chúa xứ
bánh tét lá cẩm vĩnh long	bánh tét lá cẩm vĩnh long
park hyatt sài gòn	park hyatt sài gòn
tour du lịch đảo lý sơn	tour du lịch đảo lý sơn
intercontinental danang sun peninsula resort (đà nẵng)	intercontinental danang sun peninsula resort (đà nẵng)
nhà hàng vườn xoài	nhà hàng vườn xoài
hanoi la siesta central hotel & spa	hanoi la siesta central hotel & spa
vincom center sài gòn	vincom center sài gòn
khu du lịch ghềnh ráng	khu du lịch ghềnh ráng
ba be market	ba be market
tour du lịch thái nguyên	tour du lịch thái nguyên
tour hà nội - văn miếu - quốc tử giám - hồ gươm	tour hà nội - văn miếu - quốc tử giám - hồ gươm
nhà hàng sơn la	nhà hàng sơn la
biển thiên cầm	biển thiên cầm
bánh bò thốt nốt	bánh bò thốt nốt
khu du lịch hồ mây	khu du lịch hồ mây
tour đảo bình ba	tour đảo bình ba
phan thanh giản	phan thanh giản
sa house bắc hà	sa house bắc hà
tour du lịch tam đảo	tour du lịch tam đảo
khách sạn sài gòn quảng bình	khách sạn sài gòn quảng bình
chợ nổi bạc liêu	chợ nổi bạc liêu
resort mekong riverside	resort mekong riverside
nguyễn hữu cảnh	nguyễn hữu cảnh
bánh nhãn nam định	bánh nhãn nam định
nhà hàng làng bưởi tân triều	nhà hàng làng bưởi tân triều
tour du lịch sơn la	tour du lịch sơn la
vincom plaza hưng yên	vincom plaza hưng yên
tà đùng topview homestay	tà đùng topview homestay
nhà hàng cơm niêu tuy hòa	nhà hàng cơm niêu tuy hòa
sa pa	sa pa
khách sạn bằng giang	khách sạn bằng giang
indochine cafe kon tum	indochine cafe kon tum
nguyễn sinh sắc	nguyễn sinh sắc
lễ hội kỳ yên thượng điền	lễ hội kỳ yên thượng điền
le petit dalat restaurant	le petit dalat restaurant
tam coc bungalow	tam coc bungalow
tour quy nhơn	tour quy nhơn
khách sạn mường thanh bắc giang	khách sạn mường thanh bắc giang
festival huế	festival huế
khu du lịch sinh thái suối mơ	khu du lịch sinh thái suối mơ
trang tien plaza hanoi	trang tien plaza hanoi
saigon-ninh chu hotel & resort	saigon-ninh chu hotel & resort
núi lớn	núi lớn
gỏi cá nam ô đà nẵng	gỏi cá nam ô đà nẵng
khách sạn metropole hà nội	khách sạn metropole hà nội
gio bien resort	gio bien resort
intercontinental hanoi westlake	intercontinental hanoi westlake
chợ phan thiết	chợ phan thiết
tour du lịch sinh thái hậu giang	tour du lịch sinh thái hậu giang
avani hai phong harbour view hotel	avani hai phong harbour view hotel
cargo club restaurant	cargo club restaurant
làng nôm	làng nôm
công viên hoàng văn thụ	công viên hoàng văn thụ
nhà hàng dân tộc quán	nhà hàng dân tộc quán
mường thanh holiday lý sơn	mường thanh holiday lý sơn
khách sạn bom bo	khách sạn bom bo
ben thanh street food market	ben thanh street food market
chợ san thàng	chợ san thàng
phong nha lake house resort quảng bình	phong nha lake house resort quảng bình
trịnh công sơn	trịnh công sơn
chùa hang	chùa hang
trung tâm thương mại vincom plaza tây ninh	trung tâm thương mại vincom plaza tây ninh
vincom plaza hải phòng	vincom plaza hải phòng
dic star hotels & resorts vĩnh phúc	dic star hotels & resorts vĩnh phúc
tour du lịch vĩnh phúc	tour du lịch vĩnh phúc
the pepper tree restaurant	the pepper tree restaurant
mekong home bến tre	mekong home bến tre
quảng trường hùng vương	quảng trường hùng vương
sunrise premium resort hội an	sunrise premium resort hội an
bánh tráng nướng đà lạt	bánh tráng nướng đà lạt
tour du lịch vĩnh long	tour du lịch vĩnh long
the reed hotel ninh bình	the reed hotel ninh bình
bánh ướt diên khánh	bánh ướt diên khánh
khách sạn sofitel legend metropole hà nội	khách sạn sofitel legend metropole hà nội
lễ hội đền phù ủng	lễ hội đền phù ủng
nem ninh hòa	nem ninh hòa
sa huỳnh resort quảng ngãi	sa huỳnh resort quảng ngãi
chùa hang thái nguyên	chùa hang thái nguyên
hoi an ancient house resort & spa	hoi an ancient house resort & spa
biển ninh chữ	biển ninh chữ
minera hot springs binh chau	minera hot springs binh chau
công viên sun world hạ long	công viên sun world hạ long
thác dray nur	thác dray nur
vinpearl discovery cua hoi	vinpearl discovery cua hoi
khách sạn tân lập	khách sạn tân lập
vườn quốc gia bến en	vườn quốc gia bến en
novotel hạ long bay	novotel hạ long bay
seagull hotel quy nhơn	seagull hotel quy nhơn
nhà hàng phố nướng	nhà hàng phố nướng
nhà hàng công tử bạc liêu	nhà hàng công tử bạc liêu
palm garden beach resort & spa	palm garden beach resort & spa
chùa bà đanh	chùa bà đanh
bún bò cay bạc liêu	bún bò cay bạc liêu
đình thổ hà	đình thổ hà
evason ana mandara nha trang	evason ana mandara nha trang
hồ cốc beach resort	hồ cốc beach resort
huỳnh thúc kháng	huỳnh thúc kháng
lễ hội chùa keo hành thiện	lễ hội chùa keo hành thiện
tour du lịch cửa lò - nghệ an	tour du lịch cửa lò - nghệ an
khách sạn becamex bình dương	khách sạn becamex bình dương
nhà hàng bình hưng	nhà hàng bình hưng
avani quy nhon resort & spa	avani quy nhon resort & spa
ngon restaurant sài gòn	ngon restaurant sài gòn
coto eco lodge	coto eco lodge
nhà hàng la maison 1888	nhà hàng la maison 1888
chợ đầm quy nhơn	chợ đầm quy nhơn
đền đông cuông	đền đông cuông
tiền giang	tiền giang
chùa một cột	chùa một cột
sheraton nha trang hotel & spa	sheraton nha trang hotel & spa
tour hà nội - văn miếu - quốc tử giám	tour hà nội - văn miếu - quốc tử giám
nhãn lồng hưng yên	nhãn lồng hưng yên
cháo vạt giường	cháo vạt giường
thác bản ba	thác bản ba
chùa kiến an cung	chùa kiến an cung
nhà hàng vĩnh hy	nhà hàng vĩnh hy
lễ hội lam kinh	lễ hội lam kinh
cao lầu thanh (hội an)	cao lầu thanh (hội an)
chợ biên hòa đồng nai	chợ biên hòa đồng nai
nhà hàng hoa ban	nhà hàng hoa ban
tour du lịch hòn tre - kiên giang	tour du lịch hòn tre - kiên giang
núi mẫu sơn	núi mẫu sơn
thác datanla	thác datanla
lễ hội vía bà linh sơn thánh mẫu	lễ hội vía bà linh sơn thánh mẫu
aniise villa resort ninh thuận	aniise villa resort ninh thuận
nha hang pho nui	nha hang pho nui
tour hạ long - núi bài thơ	tour hạ long - núi bài thơ
vinh market	vinh market
khu du lịch sinh thái đảo ó	khu du lịch sinh thái đảo ó
nhà hàng đông kinh lạng sơn	nhà hàng đông kinh lạng sơn
cá bống vùi tro lai châu	cá bống vùi tro lai châu
tour khám phá vườn quốc gia cát tiên	tour khám phá vườn quốc gia cát tiên
khách sạn vinpearl lạng sơn	khách sạn vinpearl lạng sơn
four seasons resort the nam hai	four seasons resort the nam hai
biển quất lâm	biển quất lâm
hà nội city tour	hà nội city tour
thác pú nhu	thác pú nhu
chợ xanh cao bằng	chợ xanh cao bằng
bánh khúc làng diềm bắc ninh	bánh khúc làng diềm bắc ninh
làng nghề gốm sứ bình dương	làng nghề gốm sứ bình dương
chùa thiên mụ	chùa thiên mụ
tour du lịch bắc kạn	tour du lịch bắc kạn
resort flamingo đại lải	resort flamingo đại lải
nhà hàng đồng văn (hà giang)	nhà hàng đồng văn (hà giang)
nhà hàng mango mango hội an	nhà hàng mango mango hội an
pù luông retreat	pù luông retreat
anh hùng núp	anh hùng núp
làng nổi tân lập	làng nổi tân lập
hoi an night market	hoi an night market
khách sạn hậu giang	khách sạn hậu giang
nhà hàng the pepper tree phú quốc	nhà hàng the pepper tree phú quốc
tour du lịch nghệ an	tour du lịch nghệ an
tam's cafe	tam's cafe
chợ cửa lò	chợ cửa lò
nhà hàng hải sản biển đông	nhà hàng hải sản biển đông
vườn cò tân long	vườn cò tân long
chợ hội an	chợ hội an
đền lăng sương	đền lăng sương
everland quang binh hotel	everland quang binh hotel
phạm hùng	phạm hùng
vincom plaza biên hòa đồng nai	vincom plaza biên hòa đồng nai
lễ hội mùa thu sa pa	lễ hội mùa thu sa pa
lễ hội nghinh ông cần giờ	lễ hội nghinh ông cần giờ
tà đùng resort	tà đùng resort
resort vinpearl cửa hội	resort vinpearl cửa hội
tour du lịch huế - hội an	tour du lịch huế - hội an
tour du lịch lào cai	tour du lịch lào cai
phuong nam restaurant can tho	phuong nam restaurant can tho
lan rừng resort & spa vũng tàu	lan rừng resort & spa vũng tàu
tour đà lạt 3 ngày 2 đêm	tour đà lạt 3 ngày 2 đêm
casa marina resort quy nhơn	casa marina resort quy nhơn
nhà hàng sóc trăng	nhà hàng sóc trăng
dong ba market	dong ba market
vincom plaza hạ long	vincom plaza hạ long
chùa đất sét	chùa đất sét
chả tôm thanh hóa	chả tôm thanh hóa
victoria can tho resort	victoria can tho resort
trần hưng đạo	trần hưng đạo
huynh duc hotel	huynh duc hotel
khu du lịch sinh thái đồng sen tháp mười	khu du lịch sinh thái đồng sen tháp mười
vườn cò bằng lăng	vườn cò bằng lăng
đắk nông	đắk nông
vườn chim bạc liêu	vườn chim bạc liêu
sense city mall cần thơ	sense city mall cần thơ
nhà hàng sen vàng vĩnh phúc	nhà hàng sen vàng vĩnh phúc
nhà hàng la maison 1888 đà nẵng	nhà hàng la maison 1888 đà nẵng
the island lodge thoi son	the island lodge thoi son
bảo tàng văn hóa các dân tộc việt nam	bảo tàng văn hóa các dân tộc việt nam
tour du lịch hồ thác bà - yên bái	tour du lịch hồ thác bà - yên bái
xôi nếp nương điện biên	xôi nếp nương điện biên
the island lodge	the island lodge
vincom plaza phú quốc	vincom plaza phú quốc
lễ hội cồng chiêng hòa bình	lễ hội cồng chiêng hòa bình
lễ hội chùa bửu long	lễ hội chùa bửu long
ngon restaurant (district 1)	ngon restaurant (district 1)
tour du lịch hồ cốc - bà rịa vũng tàu	tour du lịch hồ cốc - bà rịa vũng tàu
bảo tàng hồ chí minh (hà nội)	bảo tàng hồ chí minh (hà nội)
lẩu cá đuối trương công định	lẩu cá đuối trương công định
lễ hội đền quả sơn	lễ hội đền quả sơn
lễ hội làng cổ đông hòa hiệp	lễ hội làng cổ đông hòa hiệp
thái nguyên	thái nguyên
tour du lịch hà tĩnh	tour du lịch hà tĩnh
hanoi graceful hotel	hanoi graceful hotel
vinpearl hotel cần thơ	vinpearl hotel cần thơ
phuong nam restaurant (can tho)	phuong nam restaurant (can tho)
phan bội châu	phan bội châu
tour hội an - huế	tour hội an - huế
phố cổ hội an	phố cổ hội an
đền quả sơn	đền quả sơn
nhà hàng sen vàng bắc ninh	nhà hàng sen vàng bắc ninh
núi nhỏ	núi nhỏ
cua cà mau	cua cà mau
novotel danang premier han river (đà nẵng)	novotel danang premier han river (đà nẵng)
lễ hội cà phê buôn ma thuột	lễ hội cà phê buôn ma thuột
hanoi meracus hotel 2	hanoi meracus hotel 2
kinh bắc restaurant	kinh bắc restaurant
tour du lịch hà nội	tour du lịch hà nội
tour khám phá núi langbiang tại lâm đồng	tour khám phá núi langbiang tại lâm đồng
lễ hội đua voi tại kon tum	lễ hội đua voi tại kon tum
secret garden restaurant (district 1)	secret garden restaurant (district 1)
tour du lịch quảng bình	tour du lịch quảng bình
sa dec flower village	sa dec flower village
bánh chưng phú thọ	bánh chưng phú thọ
trương tấn sang	trương tấn sang
hum vegetarian (district 3)	hum vegetarian (district 3)
lễ hội đền huyền trân	lễ hội đền huyền trân
cháo lươn nghệ an	cháo lươn nghệ an
nhà thờ con gà đà lạt	nhà thờ con gà đà lạt
biển cửa đại	biển cửa đại
bánh cuốn tuyên quang	bánh cuốn tuyên quang
hoàng ngọc hotel	hoàng ngọc hotel
resort coffee tour	resort coffee tour
pleiku square	pleiku square
chợ phiên mai châu	chợ phiên mai châu
thác trắng minh long	thác trắng minh long
bình định	bình định
carmelina beach resort	carmelina beach resort
vinpearl hotel thanh hóa	vinpearl hotel thanh hóa
bánh xèo phú yên	bánh xèo phú yên
tour khám phá vườn quốc gia tà đùng	tour khám phá vườn quốc gia tà đùng
bánh phồng sơn đốc	bánh phồng sơn đốc
cửa lò	cửa lò
tây nguyên restaurant	tây nguyên restaurant
cát bà market	cát bà market
hội an ancient house village resort and spa	hội an ancient house village resort and spa
vườn quốc gia cúc phương	vườn quốc gia cúc phương
bánh gạo rang	bánh gạo rang
cốm tú lệ	cốm tú lệ
chợ tình khâu vai	chợ tình khâu vai
vĩnh long	vĩnh long
central market	central market
ba be national park restaurant	ba be national park restaurant
sheraton hanoi hotel	sheraton hanoi hotel
thắng cố lào cai	thắng cố lào cai
bánh tổ	bánh tổ
tour hà nội - ninh bình - hạ long	tour hà nội - ninh bình - hạ long
di tích lịch sử điện biên phủ	di tích lịch sử điện biên phủ
lotte mart vung tau	lotte mart vung tau
lễ hội đền chợ củi	lễ hội đền chợ củi
saigon morin hotel	saigon morin hotel
pa pỉnh tộp	pa pỉnh tộp
khách sạn vị hoàng nam định	khách sạn vị hoàng nam định
tour bình định - phú yên	tour bình định - phú yên
hoa binh market	hoa binh market
tour đà lạt 4 ngày 3 đêm	tour đà lạt 4 ngày 3 đêm
ba be lake view homestay	ba be lake view homestay
nhà hàng ra khơi phú quốc	nhà hàng ra khơi phú quốc
tour khám phá vườn quốc gia chư mom ray	tour khám phá vườn quốc gia chư mom ray
chợ đọ xá bắc ninh	chợ đọ xá bắc ninh
chùa linh sơn trường thọ	chùa linh sơn trường thọ
kon tum	kon tum
vinpearl hotel tây ninh	vinpearl hotel tây ninh
resort mekong garden trà vinh	resort mekong garden trà vinh
núi cấm	núi cấm
võ văn kiệt	võ văn kiệt
chợ bình hưng	chợ bình hưng
canh thụt đắk nông	canh thụt đắk nông
đền thờ vua lê thái tông	đền thờ vua lê thái tông
biển hồ cốc	biển hồ cốc
lotte hotel hanoi	lotte hotel hanoi
chùa bút tháp	chùa bút tháp
tour vũng tàu	tour vũng tàu
nhà cổ bình thủy	nhà cổ bình thủy
nhà thờ chính tòa xuân lộc	nhà thờ chính tòa xuân lộc
tour sa pa - hàm rồng	tour sa pa - hàm rồng
cột cờ lũng cú	cột cờ lũng cú
the hanoi club hotel & lake palais residences	the hanoi club hotel & lake palais residences
rừng tràm trà sư	rừng tràm trà sư
hodota resort center	hodota resort center
chợ cồn	chợ cồn
nhà hàng suối giàng	nhà hàng suối giàng
hồ thang hen	hồ thang hen
tour đảo lý sơn - quảng ngãi	tour đảo lý sơn - quảng ngãi
bánh vá	bánh vá
tour trekking vườn quốc gia chư mom ray	tour trekking vườn quốc gia chư mom ray
tour du lịch khánh hòa	tour du lịch khánh hòa
cao lãnh market	cao lãnh market
nhà thờ mằng lăng	nhà thờ mằng lăng
bắc ninh	bắc ninh
cá bống sông trà	cá bống sông trà
tour trekking công viên quốc gia bạch mã	tour trekking công viên quốc gia bạch mã
tour bình thuận	tour bình thuận
khu di tích lịch sử chiến thắng xương giang	khu di tích lịch sử chiến thắng xương giang
six senses ninh van bay	six senses ninh van bay
siêu thị co.opmart quảng ngãi	siêu thị co.opmart quảng ngãi
vincom plaza biên hòa	vincom plaza biên hòa
muong thanh grand quang tri hotel	muong thanh grand quang tri hotel
bánh pía sóc trăng	bánh pía sóc trăng
pilgrimage village boutique resort & spa	pilgrimage village boutique resort & spa
hoàng hoa thám	hoàng hoa thám
lễ hội cầu ngư	lễ hội cầu ngư
chợ vinh	chợ vinh
v resort	v resort
l'escale restaurant can tho	l'escale restaurant can tho
lễ hội hoa dã quỳ	lễ hội hoa dã quỳ
ba na hills	ba na hills
tour du lịch hồ đại lải	tour du lịch hồ đại lải
tour tháp po klong garai	tour tháp po klong garai
tuyên quang	tuyên quang
vincom plaza phu quoc	vincom plaza phu quoc
hoa binh hotel	hoa binh hotel
mui ne hills bliss hotel	mui ne hills bliss hotel
cháo canh quảng bình	cháo canh quảng bình
chau doc market	chau doc market
cái khế market	cái khế market
bún chả cá nha trang	bún chả cá nha trang
lễ hội chử đồng tử - tiên dung	lễ hội chử đồng tử - tiên dung
chợ biên hòa	chợ biên hòa
bánh gai chiêm hóa	bánh gai chiêm hóa
trần thị hồng sương	trần thị hồng sương
thung lũng tình yêu	thung lũng tình yêu
hồ tuyền lâm	hồ tuyền lâm
hanoi marvellous hotel & spa	hanoi marvellous hotel & spa
bánh tráng nướng mắm ruốc bình thuận	bánh tráng nướng mắm ruốc bình thuận
caravelle saigon	caravelle saigon
vườn quốc gia pù mát	vườn quốc gia pù mát
bánh hỏi lòng heo	bánh hỏi lòng heo
imperial hotel vung tau	imperial hotel vung tau
nhà hàng tuyên quang	nhà hàng tuyên quang
hà nội street food tour	hà nội street food tour
nguyễn khắc hiếu	nguyễn khắc hiếu
cinebox quy nhơn	cinebox quy nhơn
tour du lịch tuyên quang	tour du lịch tuyên quang
tour di sản miền trung	tour di sản miền trung
sailing club resort phu quoc	sailing club resort phu quoc
chùa trấn quốc	chùa trấn quốc
khách sạn sunrise tây ninh	khách sạn sunrise tây ninh
lợn cắp nách lào cai	lợn cắp nách lào cai
hà giang resort	hà giang resort
nhà hàng mai châu	nhà hàng mai châu
khu di tích nguyễn du	khu di tích nguyễn du
ninh kieu riverside hotel	ninh kieu riverside hotel
chùa monivongsa bopharam	chùa monivongsa bopharam
khu du lịch sinh thái hồ bể	khu du lịch sinh thái hồ bể
topas ecolodge sapa	topas ecolodge sapa
hotel majestic saigon	hotel majestic saigon
chợ sóc trăng	chợ sóc trăng
chợ nổi cái răng	chợ nổi cái răng
forever green resort	forever green resort
chùa dâu	chùa dâu
resort sài gòn - bản giốc	resort sài gòn - bản giốc
lễ hội dạ cổ hoài lang	lễ hội dạ cổ hoài lang
hanoi hilton opera	hanoi hilton opera
mũi cà mau	mũi cà mau
ecogarden resort	ecogarden resort
tour du lịch cồn ốc bến tre	tour du lịch cồn ốc bến tre
tour du lịch nha trang	tour du lịch nha trang
chả cuốn lá bưởi hòa bình	chả cuốn lá bưởi hòa bình
khách sạn quê hương	khách sạn quê hương
vincom plaza vĩnh yên	vincom plaza vĩnh yên
lẩu mắm vĩnh long	lẩu mắm vĩnh long
resort mỹ khánh	resort mỹ khánh
chợ tam đảo	chợ tam đảo
ben tre riverside resort	ben tre riverside resort
chợ nổi cà mau	chợ nổi cà mau
khu di tích lịch sử atk định hóa	khu di tích lịch sử atk định hóa
núi langbiang	núi langbiang
làng hoa sa đéc	làng hoa sa đéc
chả ram tôm đất	chả ram tôm đất
sailing club resort mui ne	sailing club resort mui ne
nhà thờ đức bà sài gòn	nhà thờ đức bà sài gòn
cá lóc nướng trui cà mau	cá lóc nướng trui cà mau
bảo tàng trần phú (hà tĩnh)	bảo tàng trần phú (hà tĩnh)
chùa hội khánh	chùa hội khánh
bánh tráng cuốn thịt heo đại lộc	bánh tráng cuốn thịt heo đại lộc
bánh bông lan trứng muối vũng tàu	bánh bông lan trứng muối vũng tàu
chợ dương đông	chợ dương đông
thác bản giốc	thác bản giốc
muong thanh grand tuyen quang hotel	muong thanh grand tuyen quang hotel
khánh hòa	khánh hòa
chợ xóm lưới	chợ xóm lưới
nhà hàng đồng văn	nhà hàng đồng văn
bánh xèo cần thơ	bánh xèo cần thơ
somerset central td hải phòng	somerset central td hải phòng
sandals restaurant & bar mui ne	sandals restaurant & bar mui ne
hải đăng đại lãnh	hải đăng đại lãnh
đền cửa ông	đền cửa ông
hoàng liên sơn	hoàng liên sơn
chùa bổ đà	chùa bổ đà
pan pacific hanoi	pan pacific hanoi
bạch dinh	bạch dinh
resort sông đốc	resort sông đốc
tour du lịch địa đạo củ chi - sài gòn	tour du lịch địa đạo củ chi - sài gòn
tour du lịch điện biên phủ	tour du lịch điện biên phủ
tour du lịch đà nẵng - hội an	tour du lịch đà nẵng - hội an
nhà hàng hậu giang	nhà hàng hậu giang
thừa thiên huế	thừa thiên huế
lăng thoại ngọc hầu	lăng thoại ngọc hầu
chợ vĩnh yên	chợ vĩnh yên
tour hưng yên	tour hưng yên
tour du lịch kiên giang	tour du lịch kiên giang
chùa minh thành	chùa minh thành
bánh phu thê bắc ninh	bánh phu thê bắc ninh
đồng nai	đồng nai
nhà hàng vị hoàng nam định	nhà hàng vị hoàng nam định
tre xanh plaza hotel	tre xanh plaza hotel
tour hạ long - cát bà	tour hạ long - cát bà
bún đỏ đắk lắk	bún đỏ đắk lắk
chợ mường thanh điện biên	chợ mường thanh điện biên
tour du lịch quảng nam	tour du lịch quảng nam
động tam thanh	động tam thanh
nghĩa trang liệt sĩ thành phố hồ chí minh	nghĩa trang liệt sĩ thành phố hồ chí minh
muong thanh grand thanh hoa hotel	muong thanh grand thanh hoa hotel
khách sạn mường thanh grand phương đông	khách sạn mường thanh grand phương đông
tour du lịch cao bằng	tour du lịch cao bằng
khách sạn hồng đức ninh thuận	khách sạn hồng đức ninh thuận
làng rau trà quế	làng rau trà quế
tour du lịch vườn quốc gia bến en	tour du lịch vườn quốc gia bến en
chợ con cuông	chợ con cuông
nhà thờ gỗ kon tum	nhà thờ gỗ kon tum
vincom center	vincom center
nhà hát lớn hải phòng	nhà hát lớn hải phòng
chợ đồ sơn	chợ đồ sơn
lễ hội lim	lễ hội lim
hồ tiền phong	hồ tiền phong
novotel ha long bay hotel	novotel ha long bay hotel
lăng cụ phó bảng nguyễn sinh sắc	lăng cụ phó bảng nguyễn sinh sắc
tour leo núi bạch mộc lương tử	tour leo núi bạch mộc lương tử
chợ thác bà	chợ thác bà
mường thanh grand điện biên phủ	mường thanh grand điện biên phủ
vườn quốc gia tràm chim	vườn quốc gia tràm chim
tour hội an - đà nẵng	tour hội an - đà nẵng
khu du lịch sinh thái bò cạp vàng	khu du lịch sinh thái bò cạp vàng
cua vàng restaurant hạ long	cua vàng restaurant hạ long
hoàng anh gia lai hotel	hoàng anh gia lai hotel
tour cù lao chàm	tour cù lao chàm
chợ ninh hải	chợ ninh hải
bac my an resort	bac my an resort
lễ hội điện hòn chén	lễ hội điện hòn chén
nguyễn hữu tiến	nguyễn hữu tiến
công viên thủ lệ	công viên thủ lệ
bánh củ cải bạc liêu	bánh củ cải bạc liêu
sài gòn đông hà hotel	sài gòn đông hà hotel
siêu thị co.opmart cà mau	siêu thị co.opmart cà mau
nhà hàng madame lân đà nẵng	nhà hàng madame lân đà nẵng
trương vĩnh ký	trương vĩnh ký
sen restaurant	sen restaurant
chợ đổ	chợ đổ
anantara quy nhon villas	anantara quy nhon villas
núi đá dựng	núi đá dựng
lễ hội hoa ban	lễ hội hoa ban
chợ đêm ninh kiều	chợ đêm ninh kiều
tour hà nội - văn miếu - quốc tử giám - lăng bác	tour hà nội - văn miếu - quốc tử giám - lăng bác
chợ trà vinh	chợ trà vinh
tour sinh thái vườn quốc gia cát tiên	tour sinh thái vườn quốc gia cát tiên
lễ hội hoa tam giác mạch	lễ hội hoa tam giác mạch
khu di tích trần phú (hà nội)	khu di tích trần phú (hà nội)
tour du lịch lịch sử thành phố hồ chí minh	tour du lịch lịch sử thành phố hồ chí minh
cá lóc nướng trui hậu giang	cá lóc nướng trui hậu giang
tour cần thơ	tour cần thơ
lễ hội pháo hoa cao bằng	lễ hội pháo hoa cao bằng
him lam resort điện biên	him lam resort điện biên
ba be lake restaurant	ba be lake restaurant
tuyen quang hotel	tuyen quang hotel
legacy yên tử - mgallery	legacy yên tử - mgallery
chùa láng cát	chùa láng cát
ngan nga bac ha hotel	ngan nga bac ha hotel
chùa bái đính	chùa bái đính
vincom plaza bắc ninh	vincom plaza bắc ninh
lễ hội quán thế âm	lễ hội quán thế âm
nhà hàng hồng hạnh 3 hạ long	nhà hàng hồng hạnh 3 hạ long
tour hà nội - di sản văn hóa	tour hà nội - di sản văn hóa
thành cổ vinh	thành cổ vinh
vincom plaza phủ lý	vincom plaza phủ lý
động thiên đường	động thiên đường
phú thọ	phú thọ
buôn đôn	buôn đôn
tháp cổ bình thạnh	tháp cổ bình thạnh
bánh tằm bì bạc liêu	bánh tằm bì bạc liêu
hanoi emerald waters hotel trendy	hanoi emerald waters hotel trendy
lẩu thả bình thuận	lẩu thả bình thuận
đại tướng võ nguyên giáp	đại tướng võ nguyên giáp
tour trekking núi langbiang tại lâm đồng	tour trekking núi langbiang tại lâm đồng
nhà hàng cơm niêu hội an quy nhơn	nhà hàng cơm niêu hội an quy nhơn
hà nội	hà nội
bánh gật gù tiên yên	bánh gật gù tiên yên
bùi xuân phái	bùi xuân phái
yersin alexandre	yersin alexandre
vườn quốc gia núi chúa	vườn quốc gia núi chúa
khu du lịch sinh thái vườn xoài	khu du lịch sinh thái vườn xoài
chợ nổi ngã năm	chợ nổi ngã năm
chợ kỳ lừa	chợ kỳ lừa
nhà hàng hồng hạnh 3	nhà hàng hồng hạnh 3
tour du lịch về nguồn	tour du lịch về nguồn
laguna lăng cô resort	laguna lăng cô resort
vạn chài resort sầm sơn	vạn chài resort sầm sơn
sheraton saigon hotel & towers	sheraton saigon hotel & towers
six senses con dao	six senses con dao
chùa vĩnh nghiêm	chùa vĩnh nghiêm
thác gia long	thác gia long
tam dao star hotel	tam dao star hotel
mỳ chũ	mỳ chũ
nhà hàng cơm niêu	nhà hàng cơm niêu
victoria chau doc hotel	victoria chau doc hotel
nhà thờ phú nhai	nhà thờ phú nhai
lễ hội áo dài thành phố hồ chí minh	lễ hội áo dài thành phố hồ chí minh
vinpearl safari phu quoc	vinpearl safari phu quoc
vincom plaza ninh bình	vincom plaza ninh bình
bánh ướt phương lang	bánh ướt phương lang
lễ hội dinh cô long hải	lễ hội dinh cô long hải
topas ecolodge	topas ecolodge
đền bà triệu	đền bà triệu
phú yên	phú yên
hồ hoàn kiếm	hồ hoàn kiếm
bánh xèo hậu giang	bánh xèo hậu giang
chim mía	chim mía
tour hành hương an giang	tour hành hương an giang
forever green resort bến tre	forever green resort bến tre
ninh kiều riverside hotel	ninh kiều riverside hotel
nho ninh thuận	nho ninh thuận
dong xuan market hanoi	dong xuan market hanoi
trung tâm thương mại vinh centre	trung tâm thương mại vinh centre
la residence hotel & spa huế	la residence hotel & spa huế
sailing club signature resort phu quoc	sailing club signature resort phu quoc
hòn chồng	hòn chồng
thác voi	thác voi
nhà hàng hải sản hoàng thao - quy nhơn	nhà hàng hải sản hoàng thao - quy nhơn
đồ sơn	đồ sơn
lễ hội chùa keo	lễ hội chùa keo
trần văn khê	trần văn khê
fusion maia resort	fusion maia resort
lễ hội thổ hà	lễ hội thổ hà
lễ hội tràng an	lễ hội tràng an
tour du lịch sầm sơn - thanh hóa	tour du lịch sầm sơn - thanh hóa
ngô thì sĩ	ngô thì sĩ
hoàng đình giong	hoàng đình giong
resort pác bó	resort pác bó
tour tây nguyên	tour tây nguyên
tòa thánh tây ninh	tòa thánh tây ninh
xuân diệu	xuân diệu
hòn yến	hòn yến
chợ đêm phố cổ	chợ đêm phố cổ
tây bắc	tây bắc
trần văn sửu	trần văn sửu
lễ hội đền thượng	lễ hội đền thượng
khách sạn mường thanh buôn ma thuột	khách sạn mường thanh buôn ma thuột
chợ đắk mil	chợ đắk mil
bánh khọt bình dương	bánh khọt bình dương
lễ hội cúng biển mỹ long	lễ hội cúng biển mỹ long
buon ma thuot market	buon ma thuot market
đồi cát bay mũi né	đồi cát bay mũi né
intercontinental phu quoc long beach resort	intercontinental phu quoc long beach resort
cơm lam đắk nông	cơm lam đắk nông
cố đô hoa lư	cố đô hoa lư
thác tác tình	thác tác tình
đền thờ nguyễn du	đền thờ nguyễn du
tour du lịch na hang - tuyên quang	tour du lịch na hang - tuyên quang
tour khám phá tây nguyên	tour khám phá tây nguyên
mekong hotel bến tre	mekong hotel bến tre
ham ninh market	ham ninh market
chợ cao bằng	chợ cao bằng
tour ninh bình	tour ninh bình
đền hùng vĩnh phúc	đền hùng vĩnh phúc
the grand ho tram strip	the grand ho tram strip
bún chả cá đà nẵng	bún chả cá đà nẵng
nha hang ngon sài gòn	nha hang ngon sài gòn
địa đạo vịnh mốc	địa đạo vịnh mốc
nguyễn đức cảnh	nguyễn đức cảnh
nhà hàng dũng tân (lào cai)	nhà hàng dũng tân (lào cai)
phong nha bamboo cafe	phong nha bamboo cafe
flc vĩnh phúc resort	flc vĩnh phúc resort
chùa chén kiểu	chùa chén kiểu
lăng huỳnh thúc kháng tại quảng nam	lăng huỳnh thúc kháng tại quảng nam
vinpearl hotel hà tĩnh	vinpearl hotel hà tĩnh
chợ châu đốc	chợ châu đốc
vinpearl resort & spa phú quốc	vinpearl resort & spa phú quốc
làng gốm thanh hà	làng gốm thanh hà
nem nướng đà lạt	nem nướng đà lạt
paradise cave restaurant quảng bình	paradise cave restaurant quảng bình
võ nguyên giáp	võ nguyên giáp
động đá bạc	động đá bạc
lễ hội tri ân các anh hùng liệt sĩ	lễ hội tri ân các anh hùng liệt sĩ
cao lãnh	cao lãnh
nguyễn thông	nguyễn thông
hoang van hotel kon tum	hoang van hotel kon tum
trung tâm thương mại vincom plaza thái nguyên	trung tâm thương mại vincom plaza thái nguyên
trung tâm thương mại vincom mega mall royal city	trung tâm thương mại vincom mega mall royal city
bình thuận	bình thuận
mui ne market	mui ne market
ana mandara villas dalat resort & spa	ana mandara villas dalat resort & spa
mường thanh điện biên phủ	mường thanh điện biên phủ
hang múa	hang múa
emeralda resort ninh bình	emeralda resort ninh bình
nguyễn chích	nguyễn chích
morning glory restaurant (hội an)	morning glory restaurant (hội an)
lễ hội đền trần	lễ hội đền trần
tour du lịch cù lao an bình	tour du lịch cù lao an bình
lễ hội bà chúa xứ	lễ hội bà chúa xứ
tour tuần châu - cát bà	tour tuần châu - cát bà
co.opmart quảng ngãi	co.opmart quảng ngãi
biển cửa tùng	biển cửa tùng
bánh cống cần thơ	bánh cống cần thơ
tour du lịch bình phước	tour du lịch bình phước
chả dông phú yên	chả dông phú yên
nhà hàng cơm niêu yên tử	nhà hàng cơm niêu yên tử
chợ sa đéc	chợ sa đéc
khách sạn đắk nông	khách sạn đắk nông
bánh gai nam định	bánh gai nam định
khách sạn quê hương sóc trăng	khách sạn quê hương sóc trăng
nguyễn duy hiệu	nguyễn duy hiệu
núi thiên ấn	núi thiên ấn
novotel danang premier han river	novotel danang premier han river
trần quốc tuấn	trần quốc tuấn
chùa long đọi sơn	chùa long đọi sơn
cồn ốc	cồn ốc
resort mỹ khánh sóc trăng	resort mỹ khánh sóc trăng
hanoi la siesta premium cau go	hanoi la siesta premium cau go
lăng phạm hùng	lăng phạm hùng
nguyễn trung trực	nguyễn trung trực
nhà hàng long an	nhà hàng long an
aniise villa resort	aniise villa resort
chùa xiêm cán	chùa xiêm cán
thác đầu đẳng	thác đầu đẳng
canh cá quỳnh côi	canh cá quỳnh côi
chùa đại tòng lâm	chùa đại tòng lâm
tam đảo	tam đảo
lễ hội quảng nam - hành trình di sản	lễ hội quảng nam - hành trình di sản
tây nguyên	tây nguyên
tour du lịch yên bái	tour du lịch yên bái
central hotel quảng ngãi	central hotel quảng ngãi
ngan nga new hotel	ngan nga new hotel
dong thap muoi eco-tourism area restaurant	dong thap muoi eco-tourism area restaurant
cai be floating market	cai be floating market
kiên giang	kiên giang
lễ hội bánh dân gian nam bộ	lễ hội bánh dân gian nam bộ
lễ hội sen đồng tháp	lễ hội sen đồng tháp
tour đà nẵng - hội an - bà nà hills	tour đà nẵng - hội an - bà nà hills
quy nhon center hotel	quy nhon center hotel
bánh tam giác mạch hà giang	bánh tam giác mạch hà giang
chợ đà lạt	chợ đà lạt
lăng mộ nguyễn đình chiểu	lăng mộ nguyễn đình chiểu
tour du lịch hòn khô - quy nhơn	tour du lịch hòn khô - quy nhơn
lễ hội nàng han	lễ hội nàng han
ninh chu bay beach club & bar	ninh chu bay beach club & bar
bảo tàng lịch sử việt nam	bảo tàng lịch sử việt nam
vĩnh phúc	vĩnh phúc
lâm đồng	lâm đồng
ho tram seafood restaurant	ho tram seafood restaurant
bamboo green hotel kon tum	bamboo green hotel kon tum
long an	long an
lễ hội tây thiên	lễ hội tây thiên
nhà thờ tắc sậy	nhà thờ tắc sậy
festival hoa đà lạt	festival hoa đà lạt
hanoi la storia hotel	hanoi la storia hotel
hanoi la selva hotel	hanoi la selva hotel
nguyễn văn đọc	nguyễn văn đọc
hồ chí minh	hồ chí minh
imperial hotel hue	imperial hotel hue
hội an market	hội an market
la residence hue hotel & spa	la residence hue hotel & spa
đền thượng	đền thượng
đền nghè	đền nghè
resort anami	resort anami
nguyễn văn linh	nguyễn văn linh
lễ hội pháo hoa quốc tế đà nẵng	lễ hội pháo hoa quốc tế đà nẵng
phố hiến hotel	phố hiến hotel
thánh địa la vang	thánh địa la vang
bến nhà rồng	bến nhà rồng
bánh phồng tôm sa giang	bánh phồng tôm sa giang
chùa long sơn	chùa long sơn
gia lai	gia lai
mekong my tho hotel	mekong my tho hotel
tour khám phá vườn quốc gia yok đôn	tour khám phá vườn quốc gia yok đôn
yến sào khánh hòa	yến sào khánh hòa
nhà hàng pù mát	nhà hàng pù mát
resort hồ núi cốc	resort hồ núi cốc
caravelle hotel sài gòn	caravelle hotel sài gòn
đèo pha đin	đèo pha đin
mì quảng đà nẵng	mì quảng đà nẵng
chợ nam du	chợ nam du
khu du lịch sinh thái đồng tháp mười	khu du lịch sinh thái đồng tháp mười
lễ hội đền trần thương	lễ hội đền trần thương
nhà thờ phát diệm	nhà thờ phát diệm
chùa tiên	chùa tiên
fusion maia danang	fusion maia danang
chùa dư hàng	chùa dư hàng
ao bà om	ao bà om
chùa hương tích (hà tĩnh)	chùa hương tích (hà tĩnh)
khách sạn thác bà	khách sạn thác bà
tour quy nhơn - bình định	tour quy nhơn - bình định
bánh đa đô lương	bánh đa đô lương
hoi an ancient house village resort & spa	hoi an ancient house village resort & spa
bánh tét trà cuôn	bánh tét trà cuôn
ancient house village resort & spa hội an	ancient house village resort & spa hội an
the imperial hotel vũng tàu	the imperial hotel vũng tàu
cá kho làng vũ đại	cá kho làng vũ đại
tour du lịch lâm đồng	tour du lịch lâm đồng
lăng võ văn kiệt	lăng võ văn kiệt
chợ đêm cà mau	chợ đêm cà mau
chameleon beach bar & restaurant mui ne	chameleon beach bar & restaurant mui ne
big c đà nẵng	big c đà nẵng
bãi xép	bãi xép
thịt trâu gác bếp lào cai	thịt trâu gác bếp lào cai
tour du lịch ninh thuận	tour du lịch ninh thuận
chợ thương bắc giang	chợ thương bắc giang
bánh giá chợ giồng	bánh giá chợ giồng
nguyễn văn tố	nguyễn văn tố
halong plaza hotel	halong plaza hotel
tour du lịch mai châu - pù luông	tour du lịch mai châu - pù luông
bình dương	bình dương
nhà tù sơn la	nhà tù sơn la
tour du lịch mai châu - mộc châu	tour du lịch mai châu - mộc châu
bánh cuốn thanh hóa	bánh cuốn thanh hóa
morning glory original hội an	morning glory original hội an
aeon mall bình dương	aeon mall bình dương
bale well restaurant	bale well restaurant
tour tây bắc	tour tây bắc
ruộng bậc thang mù cang chải	ruộng bậc thang mù cang chải
trà tân cương	trà tân cương
lễ hội chợ nổi cái răng	lễ hội chợ nổi cái răng
tour di sản văn hóa hà nội	tour di sản văn hóa hà nội
bánh xèo quảng hòa	bánh xèo quảng hòa
khách sạn mường thanh quảng trị	khách sạn mường thanh quảng trị
tôn thất tùng	tôn thất tùng
gỏi sầu đâu	gỏi sầu đâu
chợ phủ lý	chợ phủ lý
vung tau market	vung tau market
an lam retreats saigon river	an lam retreats saigon river
tương bần hưng yên	tương bần hưng yên
tây ninh	tây ninh
lăng mộ phan bội châu tại huế	lăng mộ phan bội châu tại huế
bánh ngõa	bánh ngõa
khu du lịch vinh sang	khu du lịch vinh sang
mai châu ecolodge	mai châu ecolodge
yên bái	yên bái
tour tiền giang	tour tiền giang
bánh răng bừa thanh hóa	bánh răng bừa thanh hóa
võ thị sáu	võ thị sáu
hanoi la siesta diamond hotel & spa	hanoi la siesta diamond hotel & spa
chùa cò	chùa cò
tour du lịch tiền giang	tour du lịch tiền giang
resort mũi cà mau	resort mũi cà mau
hủ tiếu nam vang	hủ tiếu nam vang
khách sạn intercontinental hanoi westlake	khách sạn intercontinental hanoi westlake
sông bến hải	sông bến hải
nhà hàng tà đùng	nhà hàng tà đùng
tour du lịch hà nam	tour du lịch hà nam
bánh căn nha trang	bánh căn nha trang
tour du lịch tràng an - bái đính	tour du lịch tràng an - bái đính
trương hán siêu	trương hán siêu
lễ hội đền củi	lễ hội đền củi
tour khám phá núi ngọc linh kon tum	tour khám phá núi ngọc linh kon tum
the grand ho tram strip resort	the grand ho tram strip resort
hủ tiếu mỹ tho	hủ tiếu mỹ tho
sen vang hotel	sen vang hotel
nhà hàng hải sản cửa lò	nhà hàng hải sản cửa lò
premier village phu quoc resort	premier village phu quoc resort
bò một nắng gia lai	bò một nắng gia lai
chợ phiên đồng văn	chợ phiên đồng văn
nguyễn khuyến	nguyễn khuyến
bánh xèo bạc liêu	bánh xèo bạc liêu
chùa ngọc hoàng	chùa ngọc hoàng
tour huế - phong nha - động thiên đường	tour huế - phong nha - động thiên đường
động phong nha	động phong nha
chợ xóm lưới vũng tàu	chợ xóm lưới vũng tàu
công viên lê văn tám	công viên lê văn tám
lẩu gà lá é đà lạt	lẩu gà lá é đà lạt
lăng chủ tịch hồ chí minh	lăng chủ tịch hồ chí minh
nhà hàng phố núi hà nam	nhà hàng phố núi hà nam
omar's namaste quảng bình	omar's namaste quảng bình
lễ hội chùa hương tích	lễ hội chùa hương tích
ba khía muối cà mau	ba khía muối cà mau
trung tâm thương mại aeon mall bình dương	trung tâm thương mại aeon mall bình dương
tour ninh thuận	tour ninh thuận
tour hà giang - cao nguyên đá đồng văn	tour hà giang - cao nguyên đá đồng văn
bánh căn ninh thuận	bánh căn ninh thuận
yên tử	yên tử
lễ hội chùa hương	lễ hội chùa hương
thiền viện trúc lâm phương nam	thiền viện trúc lâm phương nam
nhà hàng tân hương quảng trị	nhà hàng tân hương quảng trị
vùng đồng bằng sông cửu long	vùng đồng bằng sông cửu long
tour phú yên	tour phú yên
resort hòn dấu	resort hòn dấu
red dao house restaurant	red dao house restaurant
nhà hàng cargo club hội an	nhà hàng cargo club hội an
cua dai beach resort	cua dai beach resort
nhà hàng quán ốc đảo	nhà hàng quán ốc đảo
thái bình	thái bình
chợ thái nguyên	chợ thái nguyên
nhà hàng the pepper tree	nhà hàng the pepper tree
hoàng yến hotel quy nhơn	hoàng yến hotel quy nhơn
khu du lịch sinh thái lung ngọc hoàng	khu du lịch sinh thái lung ngọc hoàng
surf bar quy nhơn	surf bar quy nhơn
morning glory restaurant hoi an	morning glory restaurant hoi an
mekong rest stop	mekong rest stop
nem bùi bắc ninh	nem bùi bắc ninh
lẩu cá đuối vũng tàu	lẩu cá đuối vũng tàu
muối tôm tây ninh	muối tôm tây ninh
nhà hàng ancient hue	nhà hàng ancient hue
tỏi phan rang	tỏi phan rang
bà nà hills	bà nà hills
nhà hàng phúc hương viên tam đảo	nhà hàng phúc hương viên tam đảo
làng sen quê bác	làng sen quê bác
tour bình hưng - bình ba	tour bình hưng - bình ba
tour du lịch đắk lắk	tour du lịch đắk lắk
chợ kỳ lừa lạng sơn	chợ kỳ lừa lạng sơn
đền thờ phan bội châu	đền thờ phan bội châu
resort bình ba	resort bình ba
lễ hội văn hóa cồng chiêng tây nguyên	lễ hội văn hóa cồng chiêng tây nguyên
lễ hội yên thế	lễ hội yên thế
lễ hội đống đa - tây sơn	lễ hội đống đa - tây sơn
duc long gia lai hotel 2	duc long gia lai hotel 2
khách sạn hòn sơn	khách sạn hòn sơn
chợ vĩnh long	chợ vĩnh long
lễ hội mùa xuân	lễ hội mùa xuân
nhà hàng bình ba	nhà hàng bình ba
lễ hội phủ dầy	lễ hội phủ dầy
lạp xưởng bắc kạn	lạp xưởng bắc kạn
vincom plaza đồng hới	vincom plaza đồng hới
wyndham legend halong	wyndham legend halong
đỉnh pu ta leng	đỉnh pu ta leng
lễ hội thống nhất non sông	lễ hội thống nhất non sông
khu du lịch nhà mát	khu du lịch nhà mát
chợ bắc hà	chợ bắc hà
núi mắt thần	núi mắt thần
cat ba island resort & spa	cat ba island resort & spa
tour du lịch vịnh hạ long - quảng ninh	tour du lịch vịnh hạ long - quảng ninh
tượng đài chiến thắng điện biên phủ	tượng đài chiến thắng điện biên phủ
resort cần thơ	resort cần thơ
bạch mã village	bạch mã village
saigon kim lien hotel	saigon kim lien hotel
đà nẵng	đà nẵng
tour du lịch ninh bình	tour du lịch ninh bình
hàn mặc tử	hàn mặc tử
chợ tuyên quang	chợ tuyên quang
vườn quốc gia cát bà	vườn quốc gia cát bà
tour du lịch hồ chí minh	tour du lịch hồ chí minh
công viên quốc gia bạch mã	công viên quốc gia bạch mã
chợ hà tĩnh	chợ hà tĩnh
tour du lịch sài gòn	tour du lịch sài gòn
lễ hội nàng hai	lễ hội nàng hai
bà nà hills mountain resort	bà nà hills mountain resort
resort hòn sơn	resort hòn sơn
châu văn liêm	châu văn liêm
đảo nam du	đảo nam du
tour du lịch phú quốc 3 ngày 2 đêm	tour du lịch phú quốc 3 ngày 2 đêm
hanoi daewoo hotel	hanoi daewoo hotel
yersin	yersin
tour dmz quảng trị	tour dmz quảng trị
lễ hội đua voi buôn đôn	lễ hội đua voi buôn đôn
lễ hội nghinh ông quảng ngãi	lễ hội nghinh ông quảng ngãi
khu di tích chủ tịch hồ chí minh tại phủ chủ tịch	khu di tích chủ tịch hồ chí minh tại phủ chủ tịch
công viên châu á	công viên châu á
khâu nhục bắc kạn	khâu nhục bắc kạn
lễ hội bà đen	lễ hội bà đen
saigon quang binh hotel	saigon quang binh hotel
tour du lịch bến tre	tour du lịch bến tre
thịt trâu gác bếp lai châu	thịt trâu gác bếp lai châu
cháo ấu tẩu hà giang	cháo ấu tẩu hà giang
bánh mướt diễn châu	bánh mướt diễn châu
tour khám phá thiên nhiên ninh bình	tour khám phá thiên nhiên ninh bình
nguyễn tất thành	nguyễn tất thành
flc sầm sơn beach & golf resort	flc sầm sơn beach & golf resort
hanoi pearl hotel	hanoi pearl hotel
tour tây ninh	tour tây ninh
khách sạn aurora đồng nai	khách sạn aurora đồng nai
terracotta hotel & resort đà lạt	terracotta hotel & resort đà lạt
khách sạn minh phượng	khách sạn minh phượng
helio center	helio center
cà đắng đắk lắk	cà đắng đắk lắk
nhà hàng bách hỷ	nhà hàng bách hỷ
the grand hồ tràm strip	the grand hồ tràm strip
nhà hàng hải sản đồ sơn	nhà hàng hải sản đồ sơn
chợ vườn hoa thanh hóa	chợ vườn hoa thanh hóa
royal lotus hotel ha long	royal lotus hotel ha long
núi bà đen	núi bà đen
ninh chu hotel	ninh chu hotel
bac huong hotel kon tum	bac huong hotel kon tum
trung tâm thương mại vincom plaza bắc ninh	trung tâm thương mại vincom plaza bắc ninh
sanctuary ho tram resort community	sanctuary ho tram resort community
big c huế	big c huế
trung tâm thương mại vincom plaza buôn ma thuột	trung tâm thương mại vincom plaza buôn ma thuột
hanoi la siesta trendy hotel & spa	hanoi la siesta trendy hotel & spa
nguyễn thiện thành	nguyễn thiện thành
bánh căn đà lạt	bánh căn đà lạt
khách sạn phố hiến	khách sạn phố hiến
lý sơn pearl island hotel & resort	lý sơn pearl island hotel & resort
tô hiệu	tô hiệu
nguyễn bỉnh khiêm	nguyễn bỉnh khiêm
tour hà nội 1 ngày	tour hà nội 1 ngày
nguyễn thị minh khai	nguyễn thị minh khai
đồng tháp	đồng tháp
tour du lịch quảng ngãi	tour du lịch quảng ngãi
nhà hàng cua vàng hạ long	nhà hàng cua vàng hạ long
thác pongour	thác pongour
khu du lịch cửa biển	khu du lịch cửa biển
bánh bèo quảng bình	bánh bèo quảng bình
đỉnh fansipan	đỉnh fansipan
chợ đồng xuân	chợ đồng xuân
intercontinental danang sun peninsula resort	intercontinental danang sun peninsula resort
tour du lịch sinh thái u minh thượng	tour du lịch sinh thái u minh thượng
hủ tiếu hấp kiên giang	hủ tiếu hấp kiên giang
hanoi golden moon hotel	hanoi golden moon hotel
bánh cuốn trứng lạng sơn	bánh cuốn trứng lạng sơn
chợ đêm lý sơn	chợ đêm lý sơn
vùng đông bắc bộ	vùng đông bắc bộ
nhút thanh chương	nhút thanh chương
tour huế - quảng bình - quảng trị	tour huế - quảng bình - quảng trị
tour buôn đôn đắk lắk	tour buôn đôn đắk lắk
chợ hàn đà nẵng	chợ hàn đà nẵng
tour quảng ninh - bãi cháy	tour quảng ninh - bãi cháy
đền kỳ cùng	đền kỳ cùng
lễ hội đền hùng	lễ hội đền hùng
đền lảnh giang	đền lảnh giang
fusion suites danang beach	fusion suites danang beach
hang động chư bluk	hang động chư bluk
hoàng anh gia lai resort	hoàng anh gia lai resort
royal palace hotel tuyen quang	royal palace hotel tuyen quang
chùa dơi	chùa dơi
lễ hội đua thuyền truyền thống quảng bình	lễ hội đua thuyền truyền thống quảng bình
tour du lịch sinh thái đồng tháp mười	tour du lịch sinh thái đồng tháp mười
vincom plaza tuy hòa	vincom plaza tuy hòa
festival biển nha trang	festival biển nha trang
chợ long hoa	chợ long hoa
hanoi elegance diamond hotel	hanoi elegance diamond hotel
cồn quy	cồn quy
tour hà giang	tour hà giang
tour bắc giang	tour bắc giang
lễ hội ẩm thực đường phố thành phố hồ chí minh	lễ hội ẩm thực đường phố thành phố hồ chí minh
hòn đá bạc	hòn đá bạc
khách sạn mường thanh lạng sơn	khách sạn mường thanh lạng sơn
hồ đại lải	hồ đại lải
lễ hội ok om bok hậu giang	lễ hội ok om bok hậu giang
rory's beach bar	rory's beach bar
cơm nắm lá cọ	cơm nắm lá cọ
nem nướng cần thơ	nem nướng cần thơ
tour du lịch thanh hóa	tour du lịch thanh hóa
bún chả hà nội	bún chả hà nội
khu lưu niệm phan bội châu tại nghệ an	khu lưu niệm phan bội châu tại nghệ an
hà nội cyclo tour	hà nội cyclo tour
bánh mì cay hải phòng	bánh mì cay hải phòng
hoa binh restaurant	hoa binh restaurant
nhà hàng nam du	nhà hàng nam du
vĩnh hy resort	vĩnh hy resort
bún đỏ kon tum	bún đỏ kon tum
bánh ướt lòng gà đà lạt	bánh ướt lòng gà đà lạt
resort ana mandara villas dalat	resort ana mandara villas dalat
quan an ngon	quan an ngon
allegro hoi an	allegro hoi an
khách sạn cửu long trà vinh	khách sạn cửu long trà vinh
lễ hội cốm mễ trì	lễ hội cốm mễ trì
nem cua bể hải phòng	nem cua bể hải phòng
tour du thuyền vịnh hạ long - quảng ninh	tour du thuyền vịnh hạ long - quảng ninh
hanoi elite hotel	hanoi elite hotel
phan châu trinh	phan châu trinh
sofitel legend metropole hanoi	sofitel legend metropole hanoi
bánh đa cua hải phòng	bánh đa cua hải phòng
lễ hội nghinh ông cà mau	lễ hội nghinh ông cà mau
chau doc victoria hotel	chau doc victoria hotel
vùng đồng bằng sông hồng	vùng đồng bằng sông hồng
trung tâm thương mại lotte center hà nội	trung tâm thương mại lotte center hà nội
khách sạn cao nguyên đá (hà giang)	khách sạn cao nguyên đá (hà giang)
lễ hội đền cuông	lễ hội đền cuông
dong ba market huế	dong ba market huế
khách sạn sa đéc	khách sạn sa đéc
bãi biển an bàng	bãi biển an bàng
lễ hội nghinh ông tiền giang	lễ hội nghinh ông tiền giang
đền trần	đền trần
bắc bộ	bắc bộ
chợ mai châu	chợ mai châu
lễ hội đền đông cuông	lễ hội đền đông cuông
nem chua thanh hóa	nem chua thanh hóa
cơm lam hòa bình	cơm lam hòa bình
lễ hội chùa bà thiên hậu	lễ hội chùa bà thiên hậu
central lý sơn	central lý sơn
chùa bửu phong	chùa bửu phong
bánh xèo mười xiềm	bánh xèo mười xiềm
tour huế	tour huế
khách sạn mường thanh lào cai	khách sạn mường thanh lào cai
cát bà	cát bà
sen restaurant hanoi	sen restaurant hanoi
cannon fort cat ba	cannon fort cat ba
saigon can tho hotel	saigon can tho hotel
bánh bèo bì mỹ liên	bánh bèo bì mỹ liên
trung tâm thương mại buôn ma thuột	trung tâm thương mại buôn ma thuột
ganesh indian restaurant mui ne	ganesh indian restaurant mui ne
sepon boutique resort	sepon boutique resort
phố hiến	phố hiến
khách sạn tuyên quang	khách sạn tuyên quang
cargo club cafe & restaurant hội an	cargo club cafe & restaurant hội an
chè huế	chè huế
ba be lake view resort	ba be lake view resort
chùa thích ca phật đài	chùa thích ca phật đài
khách sạn vị hoàng	khách sạn vị hoàng
victoria núi sam lodge	victoria núi sam lodge
hồ xuân hương	hồ xuân hương
tour du lịch hội an	tour du lịch hội an
nhà hàng phố hiến nam định	nhà hàng phố hiến nam định
khu bảo tồn thiên nhiên lung ngọc hoàng	khu bảo tồn thiên nhiên lung ngọc hoàng
công viên tao đàn	công viên tao đàn
lễ hội nghinh ông cửa đại	lễ hội nghinh ông cửa đại
humiso nam du resort	humiso nam du resort
gà nướng đắk nông	gà nướng đắk nông
cơm lam đắk lắk	cơm lam đắk lắk
cù lao mái nhà	cù lao mái nhà
chợ bầu hà nam	chợ bầu hà nam
trà vinh	trà vinh
nhà hàng cây bàng	nhà hàng cây bàng
secret garden restaurant	secret garden restaurant
trần thọ	trần thọ
tour bình dương	tour bình dương
lẩu mắm long an	lẩu mắm long an
nhà hàng hồng hạnh hạ long	nhà hàng hồng hạnh hạ long
nhà hàng làng biển	nhà hàng làng biển
saigon ninh chu hotel & resort	saigon ninh chu hotel & resort
nhà hàng quê hương	nhà hàng quê hương
indochine hotel kon tum	indochine hotel kon tum
tam coc craft market	tam coc craft market
lễ hội đầm ô loan	lễ hội đầm ô loan
lễ hội văn hóa các dân tộc s'tiêng	lễ hội văn hóa các dân tộc s'tiêng
cá lóc nướng trui vĩnh long	cá lóc nướng trui vĩnh long
nguyễn khắc viện	nguyễn khắc viện
đền thờ nguyễn đức cảnh (thái bình)	đền thờ nguyễn đức cảnh (thái bình)
bánh cuốn thanh trì	bánh cuốn thanh trì
hạt điều rang muối	hạt điều rang muối
chez loan restaurant	chez loan restaurant
la veranda resort phu quoc	la veranda resort phu quoc
muong thanh luxury nhat le hotel	muong thanh luxury nhat le hotel
nhà hàng xin chào phú quốc	nhà hàng xin chào phú quốc
the hill station signature restaurant	the hill station signature restaurant
ninh thuận	ninh thuận
chùa đại tuệ	chùa đại tuệ
vườn quốc gia bù gia mập	vườn quốc gia bù gia mập
hòn phụ tử	hòn phụ tử
bánh trùng mật mía	bánh trùng mật mía
lễ hội đua thuyền truyền thống trên sông thạch hãn	lễ hội đua thuyền truyền thống trên sông thạch hãn
bamboo green hotel	bamboo green hotel
tour trà vinh	tour trà vinh
7th heaven restaurant quảng bình	7th heaven restaurant quảng bình
ganh hao restaurant vung tau	ganh hao restaurant vung tau
tour du lịch đồ sơn - hải phòng	tour du lịch đồ sơn - hải phòng
tour đà nẵng	tour đà nẵng
khách sạn nam cường nam định	khách sạn nam cường nam định
bảo tàng khmer sóc trăng	bảo tàng khmer sóc trăng
cát bà sunrise resort	cát bà sunrise resort
thác dambri	thác dambri
bánh bột lọc quảng bình	bánh bột lọc quảng bình
sunsea resort mui ne	sunsea resort mui ne
khách sạn best cm	khách sạn best cm
khách sạn lý sơn	khách sạn lý sơn
lâm ngươn tánh	lâm ngươn tánh
tour đà nẵng - huế	tour đà nẵng - huế
lễ hội hoa ban điện biên	lễ hội hoa ban điện biên
nhà hàng cánh buồm vàng	nhà hàng cánh buồm vàng
nhà hàng sầm sơn	nhà hàng sầm sơn
khu lưu niệm nhạc sĩ cao văn lầu	khu lưu niệm nhạc sĩ cao văn lầu
vinpearl hotel can tho	vinpearl hotel can tho
bánh ngải bắc kạn	bánh ngải bắc kạn
biển bạc liêu	biển bạc liêu
tràng an market	tràng an market
tour du lịch bạc liêu	tour du lịch bạc liêu
sơn la	sơn la
lễ hội nghinh ông bến tre	lễ hội nghinh ông bến tre
azerai la residence, huế	azerai la residence, huế
cá nướng	cá nướng
bến ninh kiều	bến ninh kiều
tour huế 1 ngày	tour huế 1 ngày
tour khám phá hang động quảng bình	tour khám phá hang động quảng bình
nhà hàng sen vàng	nhà hàng sen vàng
sun spa resort quảng bình	sun spa resort quảng bình
tour du lịch bắc hà	tour du lịch bắc hà
lẩu mắm bà sáu	lẩu mắm bà sáu
hồ chiềng khoi	hồ chiềng khoi
trang an valley bungalow	trang an valley bungalow
vincom plaza vĩnh phúc	vincom plaza vĩnh phúc
carnaval hạ long	carnaval hạ long
hồ núi cốc	hồ núi cốc
cù lao chàm	cù lao chàm
nhà hàng trống đồng đà lạt	nhà hàng trống đồng đà lạt
tam cốc - bích động	tam cốc - bích động
tour du lịch bắc bộ	tour du lịch bắc bộ
suối nước moọc	suối nước moọc
lễ hội hoa phượng đỏ	lễ hội hoa phượng đỏ
bánh đa kế	bánh đa kế
mì quảng	mì quảng
xôi ngũ sắc	xôi ngũ sắc
mường thanh luxury phú thọ	mường thanh luxury phú thọ
pizza 4p's (district 1)	pizza 4p's (district 1)
khách sạn sài gòn - ban mê	khách sạn sài gòn - ban mê
bánh cuốn chả phủ lý	bánh cuốn chả phủ lý
đền đô	đền đô
lăng châu văn liêm	lăng châu văn liêm
victoria nui sam lodge	victoria nui sam lodge
amanoi resort ninh thuận	amanoi resort ninh thuận
đền bảo hà	đền bảo hà
lễ hội gióng	lễ hội gióng
nhà hàng cây bàng ninh thuận	nhà hàng cây bàng ninh thuận
nhà hàng quán hoa	nhà hàng quán hoa
flc luxury resort sầm sơn	flc luxury resort sầm sơn
nghĩa trang hòa sơn, đà nẵng	nghĩa trang hòa sơn, đà nẵng
lễ hội vườn trái cây tiền giang	lễ hội vườn trái cây tiền giang
công viên ninh kiều	công viên ninh kiều
an giang	an giang
cù lao thới sơn	cù lao thới sơn
cocobay đà nẵng	cocobay đà nẵng
long hai beach resort	long hai beach resort
bánh tráng trộn	bánh tráng trộn
chùa kh'leang	chùa kh'leang
sapa market	sapa market
moc chau arena village	moc chau arena village
sense city cần thơ	sense city cần thơ
cửu thác tú sơn	cửu thác tú sơn
tour tham quan hà nội	tour tham quan hà nội
lotte mart cần thơ	lotte mart cần thơ
bánh canh ghẹ kiên giang	bánh canh ghẹ kiên giang
tour du lịch kon tum	tour du lịch kon tum
resort mũi né	resort mũi né
khách sạn mường lò	khách sạn mường lò
cù lao an bình	cù lao an bình
bún bò huế	bún bò huế
đền thờ mai hắc đế	đền thờ mai hắc đế
nhà hàng vườn ẩm thực bắc ninh	nhà hàng vườn ẩm thực bắc ninh
tour bình định	tour bình định
núi ngự bình	núi ngự bình
núi bài thơ	núi bài thơ
vịnh hạ long	vịnh hạ long
thịt nướng ống kon tum	thịt nướng ống kon tum
nhà lưu niệm trần phú (hà tĩnh)	nhà lưu niệm trần phú (hà tĩnh)
cơm lam kon tum	cơm lam kon tum
nghĩa trang liệt sĩ trường sơn	nghĩa trang liệt sĩ trường sơn
chợ sầm sơn	chợ sầm sơn
lễ hội lồng tồng	lễ hội lồng tồng
khu du lịch trung lương	khu du lịch trung lương
hanoi e central hotel	hanoi e central hotel
phở chua cao bằng	phở chua cao bằng
vườn quốc gia tà đùng	vườn quốc gia tà đùng
tour du lịch miền tây	tour du lịch miền tây
khách sạn intercontinental hà nội	khách sạn intercontinental hà nội
nhà hàng hải sản biển đông vĩnh phúc	nhà hàng hải sản biển đông vĩnh phúc
hoi an market hội an	hoi an market hội an
dinh thự họ vương	dinh thự họ vương
khách sạn aristo international lào cai	khách sạn aristo international lào cai
lễ hội hang động quảng bình	lễ hội hang động quảng bình
đỉnh bạch mộc lương tử	đỉnh bạch mộc lương tử
cháo ám	cháo ám
a la carte da nang beach	a la carte da nang beach
dalat edensee lake resort & spa	dalat edensee lake resort & spa
nhà hàng yến	nhà hàng yến
tour đà nẵng - ngũ hành sơn - bà nà hills	tour đà nẵng - ngũ hành sơn - bà nà hills
chợ thủ dầu một	chợ thủ dầu một
cat tien jungle lodge	cat tien jungle lodge
bán đảo sơn trà	bán đảo sơn trà
rex hotel sài gòn	rex hotel sài gòn
tour đắk nông	tour đắk nông
trung tâm thương mại vincom plaza huế	trung tâm thương mại vincom plaza huế
salinda resort phu quoc island	salinda resort phu quoc island
quang tri central market	quang tri central market
resort victoria núi sam	resort victoria núi sam
nhà hàng cối xay gió	nhà hàng cối xay gió
nguyễn gia thiều	nguyễn gia thiều
cao nguyên đá đồng văn	cao nguyên đá đồng văn
lễ hội ooc om boc	lễ hội ooc om boc
lễ hội thành tuyên	lễ hội thành tuyên
ninh bình	ninh bình
han market đà nẵng	han market đà nẵng
bánh khoái quảng bình	bánh khoái quảng bình
bãi môn	bãi môn
lễ hội mùa xuân sa pa	lễ hội mùa xuân sa pa
tour hạ long - tuần châu	tour hạ long - tuần châu
nhà thờ lớn hà nội	nhà thờ lớn hà nội
tour du lịch quảng trị	tour du lịch quảng trị
chợ thái bình	chợ thái bình
lễ hội trùng cửu	lễ hội trùng cửu
tree hugger cafe	tree hugger cafe
tháp bánh ít	tháp bánh ít
nhà hàng thanh trà	nhà hàng thanh trà
lê thành phương	lê thành phương
tour du lịch phú thọ	tour du lịch phú thọ
thác mơ	thác mơ
hạ long night market	hạ long night market
capture vietnam cafe quảng bình	capture vietnam cafe quảng bình
nhà hàng a1	nhà hàng a1
bamboo village beach resort & spa	bamboo village beach resort & spa
hanoi old quarter	hanoi old quarter
mạch nha quảng ngãi	mạch nha quảng ngãi
đèo mã pí lèng	đèo mã pí lèng
dusit princess moonrise beach resort	dusit princess moonrise beach resort
tour quảng bình	tour quảng bình
thác bạc	thác bạc
vinpearl resort & spa hạ long	vinpearl resort & spa hạ long
morning glory restaurant	morning glory restaurant
monkey island resort	monkey island resort
y moan	y moan
central market hội an	central market hội an
gỏi cá trích kiên giang	gỏi cá trích kiên giang
lễ hội làm chay	lễ hội làm chay
hầm đờ cát	hầm đờ cát
siêu thị co.opmart sóc trăng	siêu thị co.opmart sóc trăng
sông hồng resort	sông hồng resort
dakbla hotel kon tum	dakbla hotel kon tum
tour du lịch quảng ninh	tour du lịch quảng ninh
nhà hàng hương biển sầm sơn	nhà hàng hương biển sầm sơn
quảng nam	quảng nam
ninh thuận retreat resort	ninh thuận retreat resort
nhà hàng đại dương lý sơn	nhà hàng đại dương lý sơn
dakruco hotel	dakruco hotel
lễ hội đua ghe ngo	lễ hội đua ghe ngo
tree hugger cafe quảng bình	tree hugger cafe quảng bình
nguyễn du	nguyễn du
vịnh nha trang	vịnh nha trang
khách sạn cửu long	khách sạn cửu long
ngon restaurant	ngon restaurant
khách sạn becamex	khách sạn becamex
tour hội an	tour hội an
tour bình hưng - vĩnh hy	tour bình hưng - vĩnh hy
nhà hàng hương việt	nhà hàng hương việt
suối giàng	suối giàng
tour hà nội - hạ long - sapa	tour hà nội - hạ long - sapa
tour tham quan địa đạo củ chi	tour tham quan địa đạo củ chi
tour trekking vườn quốc gia yok đôn	tour trekking vườn quốc gia yok đôn
thành nhà hồ	thành nhà hồ
nguyễn hữu huân	nguyễn hữu huân
tour du lịch lạng sơn	tour du lịch lạng sơn
cơm lam gia lai	cơm lam gia lai
nhà hàng hoàng gia đắk nông	nhà hàng hoàng gia đắk nông
bánh bèo chợ hàng bông	bánh bèo chợ hàng bông
lan rung resort & spa	lan rung resort & spa
ho tram beach boutique resort & spa	ho tram beach boutique resort & spa
thác dray sap	thác dray sap
vườn quốc gia cát tiên	vườn quốc gia cát tiên
lễ hội đền hùng cà mau	lễ hội đền hùng cà mau
lễ hội đền kỳ cùng - tả phủ	lễ hội đền kỳ cùng - tả phủ
nhà hàng vườn vĩnh yên	nhà hàng vườn vĩnh yên
động từ thức	động từ thức
tour du lịch cần thơ	tour du lịch cần thơ
resort mỹ lệ	resort mỹ lệ
tour bắc ninh	tour bắc ninh
cối xay gió resort	cối xay gió resort
the reed hotel	the reed hotel
nhà hàng hải sản hoàng thao	nhà hàng hải sản hoàng thao
khách sạn hòn cò cà ná	khách sạn hòn cò cà ná
bánh cống bạc liêu	bánh cống bạc liêu
đền mẫu	đền mẫu
tour du lịch phú yên	tour du lịch phú yên
tour du lịch vườn quốc gia pù mát	tour du lịch vườn quốc gia pù mát
biển đồng châu	biển đồng châu
rượu mơ yên tử	rượu mơ yên tử
khách sạn mường thanh luxury bắc ninh	khách sạn mường thanh luxury bắc ninh
bánh bèo hà tĩnh	bánh bèo hà tĩnh
hưng yên	hưng yên
oxalis home quảng bình	oxalis home quảng bình
nhà hàng sen vàng bắc giang	nhà hàng sen vàng bắc giang
bản mòng	bản mòng
hậu giang	hậu giang
tour khám phá vườn quốc gia bù gia mập	tour khám phá vườn quốc gia bù gia mập
bắc giang	bắc giang
hải đăng vũng tàu	hải đăng vũng tàu
khu du lịch đại nam	khu du lịch đại nam
lễ hội nghinh ông thắng tam	lễ hội nghinh ông thắng tam
tour du lịch lai châu	tour du lịch lai châu
tour du lịch tây ninh	tour du lịch tây ninh
chợ phan rang	chợ phan rang
tour du lịch phú quốc 4 ngày 3 đêm	tour du lịch phú quốc 4 ngày 3 đêm
chợ nổi ngã năm sóc trăng	chợ nổi ngã năm sóc trăng
hoi an night market (hội an)	hoi an night market (hội an)
mekong taste restaurant	mekong taste restaurant
van kim long hotel	van kim long hotel
khu du lịch hòn khô	khu du lịch hòn khô
khách sạn dalat palace	khách sạn dalat palace
chùa bác ái	chùa bác ái
tour du lịch long hải - hồ tràm	tour du lịch long hải - hồ tràm
ben tre night market	ben tre night market
hoi an market	hoi an market
trại rắn đồng tâm	trại rắn đồng tâm
bạc liêu	bạc liêu
khách sạn mường thanh sơn la	khách sạn mường thanh sơn la
tour du lịch đồng tháp	tour du lịch đồng tháp
thành cổ châu sa	thành cổ châu sa
fusion maia resort đà nẵng	fusion maia resort đà nẵng
nguyễn văn trỗi	nguyễn văn trỗi
vinpearl resort & spa ha long	vinpearl resort & spa ha long
coffee tour resort	coffee tour resort
nhà trăm cột	nhà trăm cột
nam định	nam định
madam khanh - the banh mi queen	madam khanh - the banh mi queen
trần văn ơn	trần văn ơn
le petit dalat hotel	le petit dalat hotel
khu du lịch tam chúc	khu du lịch tam chúc
thác pa sỹ	thác pa sỹ
bánh tét lá cẩm cần thơ	bánh tét lá cẩm cần thơ
nhà hàng surf bar quy nhơn	nhà hàng surf bar quy nhơn
đầm thị nại	đầm thị nại
chợ nổi cái bè	chợ nổi cái bè
nhà hàng le chalet dalat	nhà hàng le chalet dalat
tour du lịch cà mau	tour du lịch cà mau
lai châu	lai châu
sala tuy hoa beach hotel	sala tuy hoa beach hotel
khách sạn mường thanh con cuông	khách sạn mường thanh con cuông
coto family restaurant	coto family restaurant
chợ việt trì	chợ việt trì
nhà hàng lẩu dê tài ký	nhà hàng lẩu dê tài ký
lễ hội chợ gò	lễ hội chợ gò
kẹo gương quảng ngãi	kẹo gương quảng ngãi
văn miếu - quốc tử giám	văn miếu - quốc tử giám
tour đà nẵng - bà nà hills	tour đà nẵng - bà nà hills
nhà hàng làng bưởi tân triều đồng nai	nhà hàng làng bưởi tân triều đồng nai
cao lầu hội an	cao lầu hội an
chợ tân an	chợ tân an
tour sóc trăng	tour sóc trăng
chùa phật tích	chùa phật tích
big c vinh	big c vinh
khu di tích kim liên (nghệ an)	khu di tích kim liên (nghệ an)
tour du lịch làng nổi tân lập	tour du lịch làng nổi tân lập
sa đéc flower village resort	sa đéc flower village resort
tour du lịch hồ ba bể - bắc kạn	tour du lịch hồ ba bể - bắc kạn
tour du lịch bắc giang	tour du lịch bắc giang
lễ hội đền bà chúa kho	lễ hội đền bà chúa kho
khu di tích pác bó	khu di tích pác bó
đền ỷ la	đền ỷ la
tour du lịch điện biên	tour du lịch điện biên
madame lan restaurant đà nẵng	madame lan restaurant đà nẵng
tour khám phá công viên quốc gia bạch mã	tour khám phá công viên quốc gia bạch mã
hanoi holiday diamond hotel	hanoi holiday diamond hotel
tour du lịch sinh thái đảo ó - đồng nai	tour du lịch sinh thái đảo ó - đồng nai
tour du lịch sapa	tour du lịch sapa
saigon morin hotel huế	saigon morin hotel huế
lăng tự đức	lăng tự đức
tour du lịch mũi né	tour du lịch mũi né
tour du lịch quy nhơn	tour du lịch quy nhơn
lễ hội then kin pang	lễ hội then kin pang
chợ hàn	chợ hàn
khu bảo tồn thiên nhiên kim hỷ	khu bảo tồn thiên nhiên kim hỷ
chau doc night market	chau doc night market
ngục kon tum	ngục kon tum
hồ na hang	hồ na hang
nhà hàng nam anh	nhà hàng nam anh
dinh độc lập	dinh độc lập
bánh nậm huế	bánh nậm huế
tour hà nội - hạ long	tour hà nội - hạ long
tour hà nội city	tour hà nội city
bac ha market	bac ha market
rau đồ hòa bình	rau đồ hòa bình
núi bà rá	núi bà rá
don quảng ngãi	don quảng ngãi
chợ đông kinh lạng sơn	chợ đông kinh lạng sơn
trung tâm thương mại vincom mega mall royal city hà nội	trung tâm thương mại vincom mega mall royal city hà nội
hang sơn đoòng	hang sơn đoòng
mango bay restaurant	mango bay restaurant
tour khám phá hang động phong nha	tour khám phá hang động phong nha
big c đà lạt	big c đà lạt
bánh xèo vĩnh long	bánh xèo vĩnh long
vincom plaza my tho	vincom plaza my tho
hoi an silk marina resort & spa	hoi an silk marina resort & spa
muong thanh grand cua dong hotel	muong thanh grand cua dong hotel
nhà hàng sen vàng thái nguyên	nhà hàng sen vàng thái nguyên
ben thanh market	ben thanh market
nhà hàng phương nam	nhà hàng phương nam
đền bà chúa kho	đền bà chúa kho
khách sạn sài gòn đông hà	khách sạn sài gòn đông hà
thác mu	thác mu
la siesta hoi an resort & spa	la siesta hoi an resort & spa
nghệ an	nghệ an
suối mỡ	suối mỡ
bánh bèo huế	bánh bèo huế
chau doc floating market	chau doc floating market
khách sạn đông á plaza thái nguyên	khách sạn đông á plaza thái nguyên
trung tâm thương mại trà vinh	trung tâm thương mại trà vinh
victoria châu đốc hotel	victoria châu đốc hotel
han market (đà nẵng)	han market (đà nẵng)
chợ bến tre	chợ bến tre
nhà hàng lanterns	nhà hàng lanterns
nguyễn thái học	nguyễn thái học
cơm gà cá mặn long khánh	cơm gà cá mặn long khánh
la veranda resort phu quoc - mgallery	la veranda resort phu quoc - mgallery
kẹo dừa bến tre	kẹo dừa bến tre
tour hà nội - lịch sử và văn hóa	tour hà nội - lịch sử và văn hóa
cơm hến	cơm hến
chookie's beer garden	chookie's beer garden
chợ nổi ngã bảy	chợ nổi ngã bảy
trần phú	trần phú
trang tien plaza	trang tien plaza
yên tử mountain resort	yên tử mountain resort
thịt lợn muối chua hòa bình	thịt lợn muối chua hòa bình
chùa phật ngọc xá lợi	chùa phật ngọc xá lợi
anantara mui ne resort	anantara mui ne resort
nhà hàng hương rừng	nhà hàng hương rừng
somerset central td hai phong city	somerset central td hai phong city
lễ hội nho và vang ninh thuận	lễ hội nho và vang ninh thuận
măng sặt	măng sặt
thủ khoa huân	thủ khoa huân
nguyễn văn cừ	nguyễn văn cừ
nhà hàng thanh thanh	nhà hàng thanh thanh
bánh trứng kiến cao bằng	bánh trứng kiến cao bằng
pleiku hotel	pleiku hotel
hoàng thành thăng long	hoàng thành thăng long
jw marriott phu quoc emerald bay resort & spa	jw marriott phu quoc emerald bay resort & spa
khách sạn ttc premium phan thiết	khách sạn ttc premium phan thiết
casa marina resort	casa marina resort
aira boutique sapa hotel & spa	aira boutique sapa hotel & spa
núi ngọc linh	núi ngọc linh
nhà hàng lúa nếp	nhà hàng lúa nếp
khu du lịch bửu long	khu du lịch bửu long
lương ngọc quyến	lương ngọc quyến
chợ đông hà	chợ đông hà
bưởi tân triều	bưởi tân triều
chùa thiên ấn	chùa thiên ấn
chợ tịnh biên	chợ tịnh biên
gỏi cá mai bình thuận	gỏi cá mai bình thuận
nhà thờ chánh tòa phú cường	nhà thờ chánh tòa phú cường
nguyễn thiện thuật	nguyễn thiện thuật
đảo điệp sơn	đảo điệp sơn
phở chua lạng sơn	phở chua lạng sơn
hotel nikko saigon	hotel nikko saigon
nguyễn tấn dũng	nguyễn tấn dũng
lễ hội cồng chiêng tây nguyên	lễ hội cồng chiêng tây nguyên
chợ tuy hòa	chợ tuy hòa
nhà hàng làng nướng ninh thuận	nhà hàng làng nướng ninh thuận
lăng trần thọ	lăng trần thọ
chợ thái	chợ thái
pullman vũng tàu	pullman vũng tàu
lễ hội dinh thầy thím	lễ hội dinh thầy thím
