bản Cát Cát	bản Cát Cát
hang động Sơn Đoòng	hang động Sơn Đoòng
đèn lồng truyền thống	đèn lồng truyền thống
Chùa Hương	Chùa Hương
kiến trúc cung đình	kiến trúc cung đình
Mát mẻ	Mát mẻ
lăng tẩm vua chúa	lăng tẩm vua chúa
vịnh biển	vịnh biển
nhà thờ Núi	nhà thờ Núi
UNESCO công nhận	UNESCO công nhận
cầu Vàng	cầu Vàng
Ninh Bình	Ninh Bình
Cù Lao Chàm	Cù Lao Chàm
Tràng An di sản kép	Tràng An di sản kép
kỳ quan thiên nhiên thế giới	kỳ quan thiên nhiên thế giới
thành phố ngàn hoa	thành phố ngàn hoa
chùa Thiên Mụ	chùa Thiên Mụ
Hà Nội	Hà Nội
Sơn Đoòng	Sơn Đoòng
Kinh Thành Huế	Kinh Thành Huế
nước mắm truyền thống	nước mắm truyền thống
phố cổ di sản	phố cổ di sản
nhà thờ Con Gà	nhà thờ Con Gà
trường Cao đẳng Sư phạm	trường Cao đẳng Sư phạm
sông Chày – hang Tối	sông Chày – hang Tối
khí hậu	khí hậu
Hang Sửng Sốt	Hang Sửng Sốt
văn hóa cồng chiêng Tây Nguyên	văn hóa cồng chiêng Tây Nguyên
Đèn lồng rực rỡ	Đèn lồng rực rỡ
Đồi cát bay	Đồi cát bay
đèn lồng đêm phố cổ	đèn lồng đêm phố cổ
hệ thống hang động đa dạng	hệ thống hang động đa dạng
khu bảo tồn thiên nhiên	khu bảo tồn thiên nhiên
Thung lũng Tình Yêu	Thung lũng Tình Yêu
ngọn hải đăng Vũng Tàu	ngọn hải đăng Vũng Tàu
các lăng tẩm	các lăng tẩm
di sản thiên nhiên thế giới	di sản thiên nhiên thế giới
Lạng Sơn	Lạng Sơn
cảnh quan kỳ vĩ	cảnh quan kỳ vĩ
cuộc sống về đêm	cuộc sống về đêm
Tràng An	Tràng An
vườn dâu tây	vườn dâu tây
Vịnh H	Vịnh H
Cổng Tò Vò	Cổng Tò Vò
lăng Tự Đức	lăng Tự Đức
Chu_the	Chu_the
chợ nổi Cái Răng	chợ nổi Cái Răng
chùa Cầu	chùa Cầu
kinh thành	kinh thành
Hệ thống hang động kỳ vĩ	Hệ thống hang động kỳ vĩ
hàng nghìn đảo đá vôi	hàng nghìn đảo đá vôi
Phố cổ Hội	Phố cổ Hội
rừng tràm Tràm Chim	rừng tràm Tràm Chim
Nghệ An	Nghệ An
36 phố phường	36 phố phường
thác nước lớn nhất Việt Nam	thác nước lớn nhất Việt Nam
suối nước Moọc	suối nước Moọc
Hoàng thành Thăng Long	Hoàng thành Thăng Long
Hệ thống hang động đặc sắc	Hệ thống hang động đặc sắc
thác nước	thác nước
hang động thế giới	hang động thế giới
lăng tẩm và đền đài	lăng tẩm và đền đài
Lý Sơn	Lý Sơn
phố cổ di sản thế giới	phố cổ di sản thế giới
Tây Nguyên	Tây Nguyên
rừng nhiệt đới nguyên sinh	rừng nhiệt đới nguyên sinh
Làng Gốm Bát Tràng	Làng Gốm Bát Tràng
bãi	bãi
Vịnh đá vôi	Vịnh đá vôi
hồ Gươm	hồ Gươm
kiến trúc cổ truyền	kiến trúc cổ truyền
vịnh và đảo đá vôi	vịnh và đảo đá vôi
Nha Trang	Nha Trang
Eo Gió	Eo Gió
hang động kỳ vĩ	hang động kỳ vĩ
cổng trời	cổng trời
Cà Mau	Cà Mau
đảo ngọc	đảo ngọc
bãi Sau	bãi Sau
quần đảo đá vôi	quần đảo đá vôi
Hang Sơn Đoòng	Hang Sơn Đoòng
di sản	di sản
vịnh đảo đá vôi	vịnh đảo đá vôi
lặn ngắm san hô	lặn ngắm san hô
đồi cát bay	đồi cát bay
Quảng Nam	Quảng Nam
Thành phố ngàn hoa	Thành phố ngàn hoa
Khu Dự trữ Sinh quyển Thế giới	Khu Dự trữ Sinh quyển Thế giới
vườn quốc gia Cát Bà	vườn quốc gia Cát Bà
công viên địa chất toàn cầu	công viên địa chất toàn cầu
rừng tràm Trà Sư	rừng tràm Trà Sư
Khí hậu mát mẻ	Khí hậu mát mẻ
Ruộng Bậc	Ruộng Bậc
bạch Dinh	bạch Dinh
B	B
cung đình cổ	cung đình cổ
Vịnh Lan Hạ	Vịnh Lan Hạ
quần thể di tích cố đô	quần thể di tích cố đô
ga Lào Cai	ga Lào Cai
Kinh thành Huế	Kinh thành Huế
cảnh quan đá vôi độc đáo	cảnh quan đá vôi độc đáo
làng Pháp trên núi	làng Pháp trên núi
hồ nước ngọt giữa núi rừng	hồ nước ngọt giữa núi rừng
hòn Tằm	hòn Tằm
lăng Bác	lăng Bác
lễ hội lớn nhất Việt Nam	lễ hội lớn nhất Việt Nam
thung lũng Hoa Hồng	thung lũng Hoa Hồng
khí hậu ô	khí hậu ô
lăng tẩm triều Nguyễn	lăng tẩm triều Nguyễn
Cao Bằng	Cao Bằng
núi Bà Đen	núi Bà Đen
Điện Biên	Điện Biên
núi Fansipan	núi Fansipan
cảnh quan	cảnh quan
Kinh thành	Kinh thành
Biển xanh	Biển xanh
chợ phiên	chợ phiên
vườn tiêu	vườn tiêu
Cần Giờ	Cần Giờ
Chợ nổi Cái Răng	Chợ nổi Cái Răng
làng nghề kẹo dừa	làng nghề kẹo dừa
cao nguyên đá Đồng	cao nguyên đá Đồng
chùa Một Cột	chùa Một Cột
động nước dài nhất thế giới	động nước dài nhất thế giới
chợ Đầm	chợ Đầm
hoa và nông sản	hoa và nông sản
phố cổ và kiến trúc độc đáo	phố cổ và kiến trúc độc đáo
Bình Thuận	Bình Thuận
cảnh quan thiên nhiên	cảnh quan thiên nhiên
biển trong xanh và hải sản tươi ngon	biển trong xanh và hải sản tươi ngon
biên giới Việt-Trung	biên giới Việt-Trung
Lễ hội chùa Tam Thanh	Lễ hội chùa Tam Thanh
bãi Sao cát trắng	bãi Sao cát trắng
hang động nước ngọt	hang động nước ngọt
bãi biển Sao	bãi biển Sao
di sản văn hóa thế giới	di sản văn hóa thế giới
Mù Cang Chải	Mù Cang Chải
cáp treo Fansipan	cáp treo Fansipan
cầu Rồng phun lửa	cầu Rồng phun lửa
hang động lớn nhất thế giới	hang động lớn nhất thế giới
cáp treo vượt biển	cáp treo vượt biển
dân tộc thiểu số	dân tộc thiểu số
hang động ngầm	hang động ngầm
Đèn lồng	Đèn lồng
Lăng tẩm hoàng gia	Lăng tẩm hoàng gia
Hang Sơn Đoòng lớn nhất thế giới	Hang Sơn Đoòng lớn nhất thế giới
Đèo Hải Vân	Đèo Hải Vân
bãi biển Mỹ Khê	bãi biển Mỹ Khê
Cầu Vàng Đà Nẵng	Cầu Vàng Đà Nẵng
Thủ đô	Thủ đô
Cần Thơ	Cần Thơ
ruộng bậc thang đá	ruộng bậc thang đá
Tháp Bà Ponagar	Tháp Bà Ponagar
tượng Chúa Kito	tượng Chúa Kito
Tây Ninh	Tây Ninh
cố đô cổ kính	cố đô cổ kính
ruộng bậc thang hùng vĩ	ruộng bậc thang hùng vĩ
Thánh địa Mỹ Sơn	Thánh địa Mỹ Sơn
Văn Miếu	Văn Miếu
Hang Én	Hang Én
vịnh biển kỳ quan thiên nhiên	vịnh biển kỳ quan thiên nhiên
Ngũ Hành Sơn	Ngũ Hành Sơn
cảnh quan thiên nhiên hùng vĩ	cảnh quan thiên nhiên hùng vĩ
chợ Cốc Lếu	chợ Cốc Lếu
kiến trúc cổ	kiến trúc cổ
Lễ	Lễ
đa dạng sinh học biển	đa dạng sinh học biển
kiến trúc phố cổ	kiến trúc phố cổ
Thánh địa Chăm	Thánh địa Chăm
cầu Rồng	cầu Rồng
Hải Phòng	Hải Phòng
Doi_tuong	Doi_tuong
hang động đá vôi	hang động đá vôi
Thác Bản Giốc	Thác Bản Giốc
di tích đền tháp Chăm Pa	di tích đền tháp Chăm Pa
hàng nghìn hòn đảo đá vôi	hàng nghìn hòn đảo đá vôi
Phố Cổ Hội An	Phố Cổ Hội An
vườn quốc gia Tam Đảo	vườn quốc gia Tam Đảo
phố phường cổ	phố phường cổ
Kh	Kh
Cúc Phương	Cúc Phương
Văn Miếu Quốc Tử Giám	Văn Miếu Quốc Tử Giám
vịnh biển kỳ quan thế giới	vịnh biển kỳ quan thế giới
du lịch miệt vườn	du lịch miệt vườn
Festival Huế	Festival Huế
Chợ tình Khâu Vai	Chợ tình Khâu Vai
Đảo Yến tự nhiên	Đảo Yến tự nhiên
Sơn La	Sơn La
hệ thống hang động karst	hệ thống hang động karst
tháp Chăm cổ	tháp Chăm cổ
Đảo khỉ	Đảo khỉ
Quy Nhơn	Quy Nhơn
cố đô và lăng tẩm	cố đô và lăng tẩm
làng gốm Thanh Hà	làng gốm Thanh Hà
Nước mắm truyền thống	Nước mắm truyền thống
Bãi	Bãi
truyền thuyết rùa thần	truyền thuyết rùa thần
Ruộng bậc thang	Ruộng bậc thang
Buôn Ma Thuột	Buôn Ma Thuột
Mekong Delta	Mekong Delta
cao nguyên	cao nguyên
Điện Biên Phủ	Điện Biên Phủ
động Thiên Cung	động Thiên Cung
nhà tù	nhà tù
cao nguyên đá Đồng Văn	cao nguyên đá Đồng Văn
vịnh Hạ Long trên cạn	vịnh Hạ Long trên cạn
Hang động	Hang động
hòn đảo ngọc	hòn đảo ngọc
ẩm thực cao lầu	ẩm thực cao lầu
hệ thống hang động lớn nhất thế giới	hệ thống hang động lớn nhất thế giới
làng chài Cửa Vạn	làng chài Cửa Vạn
Hạ Long Bay	Hạ Long Bay
phố cổ Hà Nội	phố cổ Hà Nội
hoạt động mua bán trên sông	hoạt động mua bán trên sông
hang Sơn Đoòng	hang Sơn Đoòng
Thành phố Hồ Chí Minh	Thành phố Hồ Chí Minh
đền Thượng	đền Thượng
lặn biển	lặn biển
Di sản văn hóa thế giới	Di sản văn hóa thế giới
Cố đô Huế	Cố đô Huế
Lào Cai	Lào Cai
cầu Tràng Tiền	cầu Tràng Tiền
Mùa xu	Mùa xu
Yên Bái	Yên Bái
Phố Cổ	Phố Cổ
lăng Minh Mạng	lăng Minh Mạng
Hạ Long trên cạn	Hạ Long trên cạn
Phố cổ UNESCO	Phố cổ UNESCO
cố	cố
cung	cung
quần thể danh thắng thiên nhiên	quần thể danh thắng thiên nhiên
Rừng tràm Trà Sư	Rừng tràm Trà Sư
nổi	nổi
Nhà rông	Nhà rông
cao nguyên đá	cao nguyên đá
Vin	Vin
hồ nước ngọt tự nhiên lớn nhất miền Bắc	hồ nước ngọt tự nhiên lớn nhất miền Bắc
chùa Bái Đính	chùa Bái Đính
ruộng bậc thang và văn hóa dân tộc	ruộng bậc thang và văn hóa dân tộc
hầm rượu Debay	hầm rượu Debay
thác nước biên giới	thác nước biên giới
kiến trúc hiện đại	kiến trúc hiện đại
hang Én	hang Én
chợ tình Sapa	chợ tình Sapa
ẩm thực cung đình	ẩm thực cung đình
Hồ Gươm	Hồ Gươm
du lịch biển	du lịch biển
Cánh đồng quạt gió Bạc Liêu	Cánh đồng quạt gió Bạc Liêu
kiến trúc phố cổ đặc trưng	kiến trúc phố cổ đặc trưng
bản Tả Van	bản Tả Van
di tích nhà tù	di tích nhà tù
lễ hội pháo hoa	lễ hội pháo hoa
đại nội Huế	đại nội Huế
khu bảo tồn đất ngập nước	khu bảo tồn đất ngập nước
hang động kỳ ảo	hang động kỳ ảo
vườn hoa Le Jardin	vườn hoa Le Jardin
hệ thống hang động phức tạp	hệ thống hang động phức tạp
phim trường "Kong: Skull Island"	phim trường "Kong: Skull Island"
hệ thống hang động lớn	hệ thống hang động lớn
đèn lồng	đèn lồng
Hội An	Hội An
bán đảo Sơn Trà	bán đảo Sơn Trà
hòn đảo	hòn đảo
khí hậu ôn đới	khí hậu ôn đới
lăng Chủ tịch Hồ Chí Minh	lăng Chủ tịch Hồ Chí Minh
Cao nguyên	Cao nguyên
bãi biển đẹp và hải sản tươi sống	bãi biển đẹp và hải sản tươi sống
thung lũng Tình Yêu	thung lũng Tình Yêu
ruộng bậc thang mùa lúa chín	ruộng bậc thang mùa lúa chín
Huế	Huế
cầu Tình Yêu	cầu Tình Yêu
bãi biển cát trắng hoang sơ	bãi biển cát trắng hoang sơ
hệ thống lăng tẩm hoàng gia	hệ thống lăng tẩm hoàng gia
Lăng tẩm vua Nguyễn	Lăng tẩm vua Nguyễn
dừa xiêm	dừa xiêm
Làng gốm Bát Tràng	Làng gốm Bát Tràng
Phở	Phở
Nhà tù lịch sử	Nhà tù lịch sử
biển Mỹ Khê	biển Mỹ Khê
hồ Xuân Hương	hồ Xuân Hương
kinh thành Huế	kinh thành Huế
thác nước biên giới Đông Nam Á	thác nước biên giới Đông Nam Á
Pù Luông	Pù Luông
Mũi Né	Mũi Né
Chợ phiên	Chợ phiên
Phố cổ Hội An	Phố cổ Hội An
Ruộng bậc thang Mù Cang Chải	Ruộng bậc thang Mù Cang Chải
văn hóa cồng chiêng	văn hóa cồng chiêng
di sản kép	di sản kép
Di sản Thiên nhiên Thế giới	Di sản Thiên nhiên Thế giới
khí hậu m	khí hậu m
thác Bản Giốc	thác Bản Giốc
Quảng Bình	Quảng Bình
thành phố sương mù	thành phố sương mù
ruộng bậc thang Mường Hoa	ruộng bậc thang Mường Hoa
thiên nhiên thế giới	thiên nhiên thế giới
Bến Tre	Bến Tre
Động Phong Nha	Động Phong Nha
ruộng bậc thang	ruộng bậc thang
hồ Ba Bể	hồ Ba Bể
di tích Chăm Pa	di tích Chăm Pa
Thác Bản Giốc hùng vĩ	Thác Bản Giốc hùng vĩ
Phú Quốc	Phú Quốc
Cao nguyên đá Đồng Văn	Cao nguyên đá Đồng Văn
di tích cổ	di tích cổ
đảo Titop	đảo Titop
cố đô	cố đô
kinh thành hoàng gia	kinh thành hoàng gia
Mũi Cà Mau	Mũi Cà Mau
hệ thống hang động	hệ thống hang động
Hòn ngọc Việt Nam	Hòn ngọc Việt Nam
Đồng Tháp	Đồng Tháp
Thủ đô Hà Nội	Thủ đô Hà Nội
hồ Dầu Tiếng	hồ Dầu Tiếng
UNESCO	UNESCO
lịch sử	lịch sử
Cánh đồng Mường Hoa	Cánh đồng Mường Hoa
thiên nhiên kỳ vĩ	thiên nhiên kỳ vĩ
làng gốm Bát Tràng	làng gốm Bát Tràng
thác nước trên đường biên	thác nước trên đường biên
cồn cát bay	cồn cát bay
nhà tù Côn Đảo	nhà tù Côn Đảo
mũi đất tận cùng Việt Nam	mũi đất tận cùng Việt Nam
Phong Nha - Kẻ Bàng	Phong Nha - Kẻ Bàng
nhà tù lịch sử	nhà tù lịch sử
cố đô di sản văn hóa	cố đô di sản văn hóa
Đà Lạt	Đà Lạt
rừng thông và khí hậu mát mẻ	rừng thông và khí hậu mát mẻ
Cố Đô	Cố Đô
cầu Vàng trên núi	cầu Vàng trên núi
chùa Gò Kén	chùa Gò Kén
tam Cốc - Bích Động	tam Cốc - Bích Động
vịnh Hạ Long	vịnh Hạ Long
ngọc trai	ngọc trai
Sapa	Sapa
kinh đô cổ	kinh đô cổ
hệ thống hang động ngầm	hệ thống hang động ngầm
Mộc Châu	Mộc Châu
Quảng Ninh	Quảng Ninh
di sản văn hóa	di sản văn hóa
khu phố cổ	khu phố cổ
Bãi Sao	Bãi Sao
cánh đồng sen	cánh đồng sen
hệ thống hang động trên sông	hệ thống hang động trên sông
chợ tình	chợ tình
ẩm thực đường phố	ẩm thực đường phố
nhà cổ Tấn Ký	nhà cổ Tấn Ký
cầu R	cầu R
Khu phố cổ	Khu phố cổ
vùng cao	vùng cao
khí hậu ôn đới và rừng thông	khí hậu ôn đới và rừng thông
thánh địa Champa cổ	thánh địa Champa cổ
sản phẩm gốm sứ truyền thống	sản phẩm gốm sứ truyền thống
vịnh đá vôi	vịnh đá vôi
biên giới Việt - Trung	biên giới Việt - Trung
bãi biển đẹp	bãi biển đẹp
Tràm Chim Quốc gia	Tràm Chim Quốc gia
Lễ hội Hoa Ban	Lễ hội Hoa Ban
nhã nhạc cung đình	nhã nhạc cung đình
Chùa Cầu	Chùa Cầu
lăng t	lăng t
Đại Nội	Đại Nội
Tam Cốc - Bích Động	Tam Cốc - Bích Động
rạn san hô	rạn san hô
bãi biển đẹp và nước biển trong xanh	bãi biển đẹp và nước biển trong xanh
ruộng bậc thang Mù Cang Chải	ruộng bậc thang Mù Cang Chải
l	l
chợ đêm Đà Lạt	chợ đêm Đà Lạt
rừng ngập mặn	rừng ngập mặn
suối Tranh	suối Tranh
hoa dã quỳ	hoa dã quỳ
nhà thờ đá	nhà thờ đá
hàng nghìn đảo đá vôi và hang động kỳ thú	hàng nghìn đảo đá vôi và hang động kỳ thú
Việt Nam	Việt Nam
văn miếu Quốc Tử Giám	văn miếu Quốc Tử Giám
ruộng b	ruộng b
chim cò đặc hữu	chim cò đặc hữu
tua-bin gió	tua-bin gió
kiến trúc cổ kính độc đáo	kiến trúc cổ kính độc đáo
cầu	cầu
phố cổ	phố cổ
tràng An	tràng An
cảnh sắc thiên nhiên	cảnh sắc thiên nhiên
đồi chè Suối Giàng	đồi chè Suối Giàng
di tích cung đình	di tích cung đình
Bắc Kạn	Bắc Kạn
Hà Giang	Hà Giang
Ngọc trai	Ngọc trai
di tích tháp Chăm cổ	di tích tháp Chăm cổ
Lăng Tự Đức	Lăng Tự Đức
vịnh Hạ Long trên c	vịnh Hạ Long trên c
chợ đêm Dương Đông	chợ đêm Dương Đông
Phong Nha-Kẻ Bàng	Phong Nha-Kẻ Bàng
phố đi bộ Hồ Gươm	phố đi bộ Hồ Gươm
đồi chè Cầu Đất	đồi chè Cầu Đất
vườn quốc gia Phong Nha – Kẻ Bàng	vườn quốc gia Phong Nha – Kẻ Bàng
Lễ hội dù lượn	Lễ hội dù lượn
cầu Vàng độc đáo	cầu Vàng độc đáo
Lăng tẩm	Lăng tẩm
hệ thống hang động dài và đẹp	hệ thống hang động dài và đẹp
đảo đá vôi và hang động kỳ thú	đảo đá vôi và hang động kỳ thú
ruộng bậc thang và văn hóa dân tộc thiểu số	ruộng bậc thang và văn hóa dân tộc thiểu số
nghệ thuật gốm sứ	nghệ thuật gốm sứ
Cồn cát	Cồn cát
ruộng bậc thang tuyệt đẹp	ruộng bậc thang tuyệt đẹp
lịch sử nhà tù thời Pháp và Mỹ	lịch sử nhà tù thời Pháp và Mỹ
Bản Cát Cát	Bản Cát Cát
Cầu Vàng với bàn tay khổng lồ	Cầu Vàng với bàn tay khổng lồ
vịnh di sản thiên nhiên thế giới	vịnh di sản thiên nhiên thế giới
Hạ Long	Hạ Long
rạn san hô và biển xanh	rạn san hô và biển xanh
phố cổ Đồng Văn	phố cổ Đồng Văn
vịnh với hàng nghìn đảo đá vôi	vịnh với hàng nghìn đảo đá vôi
Grand World	Grand World
Hồ Xuân Hương	Hồ Xuân Hương
cồn cát	cồn cát
phố cổ 36 phố phường	phố cổ 36 phố phường
bản sắc văn hóa dân tộc thiểu số	bản sắc văn hóa dân tộc thiểu số
đồi chè Mộc Châu	đồi chè Mộc Châu
thuyền buôn bán	thuyền buôn bán
Tam Cốc-Bích Động	Tam Cốc-Bích Động
chợ phiên và bản làng dân tộc thiểu số	chợ phiên và bản làng dân tộc thiểu số
phiên chợ tình yêu	phiên chợ tình yêu
phố cổ Hội An	phố cổ Hội An
vườn trái cây Phong Điền	vườn trái cây Phong Điền
tàu hỏa leo núi	tàu hỏa leo núi
hang động	hang động
thành phố	thành phố
người H'Mông	người H'Mông
cảnh quan thiên nhiên kỳ vĩ	cảnh quan thiên nhiên kỳ vĩ
lăng tẩm hoàng gia	lăng tẩm hoàng gia
bãi biển	bãi biển
Bãi biển đẹp	Bãi biển đẹp
san hô	san hô
cung đình	cung đình
dài nhất thế giới	dài nhất thế giới
Phố cổ	Phố cổ
Vườn quốc gia Tràm Chim	Vườn quốc gia Tràm Chim
nhà cổ Bình Thủy	nhà cổ Bình Thủy
làng Pháp	làng Pháp
Động Thiên Đường	Động Thiên Đường
Đồng Văn	Đồng Văn
mũi đất cuối	mũi đất cuối
thánh địa Champa	thánh địa Champa
phố cổ và đèn lồng	phố cổ và đèn lồng
nan	nan
đồi cát đỏ	đồi cát đỏ
đồi thông	đồi thông
đồi cát đỏ và trắng	đồi cát đỏ và trắng
tòa thánh Cao Đài	tòa thánh Cao Đài
đảo đá vôi	đảo đá vôi
Lễ hội pháo hoa quốc tế	Lễ hội pháo hoa quốc tế
bà Nà Hills	bà Nà Hills
Cố Đô Huế	Cố Đô Huế
phố cổ đèn lồng	phố cổ đèn lồng
cung điện và lăng t	cung điện và lăng t
kiến trúc phố cổ độc đáo	kiến trúc phố cổ độc đáo
bảo tàng văn hóa Sa Huỳnh	bảo tàng văn hóa Sa Huỳnh
Cao Nguyên Đá Đồng Văn	Cao Nguyên Đá Đồng Văn
ngàn hoa	ngàn hoa
bảo tàng Dân tộc học	bảo tàng Dân tộc học
kiến trúc cổ từ thế kỷ 15	kiến trúc cổ từ thế kỷ 15
biển Cửa Đại	biển Cửa Đại
nhà thờ đá Sapa	nhà thờ đá Sapa
Bãi biển	Bãi biển
Hồ Ba Bể	Hồ Ba Bể
hòn Mun	hòn Mun
quần thể danh thắng Tràng An	quần thể danh thắng Tràng An
khí hậu mát mẻ	khí hậu mát mẻ
kỳ quan thiên nhiên	kỳ quan thiên nhiên
lễ hội đèn lồng	lễ hội đèn lồng
hệ thống sông ngầm	hệ thống sông ngầm
phố cổ với kiến trúc độc đáo	phố cổ với kiến trúc độc đáo
kinh thành cổ	kinh thành cổ
sinh quyển thế giới	sinh quyển thế giới
kiến trúc Chăm pa	kiến trúc Chăm pa
tháp Bà Ponagar	tháp Bà Ponagar
đảo Cô Tô	đảo Cô Tô
Kiên Giang	Kiên Giang
Di sản thiên nhiên thế giới	Di sản thiên nhiên thế giới
Phong Nha	Phong Nha
Ruộng bậc thang mù sương	Ruộng bậc thang mù sương
khí hậu mát mẻ và hoa	khí hậu mát mẻ và hoa
thác nước hùng vĩ trên biên giới	thác nước hùng vĩ trên biên giới
khối thạch nhũ	khối thạch nhũ
Vịnh Hạ Long trên cạn	Vịnh Hạ Long trên cạn
Cố đô	Cố đô
kiến trúc Chăm cổ	kiến trúc Chăm cổ
thiên đường	thiên đường
đồi chè xanh mướt	đồi chè xanh mướt
Đà Nẵng	Đà Nẵng
cây cầu Vàng độc đáo	cây cầu Vàng độc đáo
thác Bản Giốc hùng vĩ	thác Bản Giốc hùng vĩ
khí hậu mát m	khí hậu mát m
ga Đà Lạt	ga Đà Lạt
rừng thông và hồ Xuân Hương	rừng thông và hồ Xuân Hương
C	C
Côn Đảo	Côn Đảo
chợ phiên dân tộc	chợ phiên dân tộc
ruộng bậc thang trải dài trên sườn núi	ruộng bậc thang trải dài trên sườn núi
đồi cát Bay	đồi cát Bay
Hòn Đá Bạc	Hòn Đá Bạc
văn hóa thế giới	văn hóa thế giới
Cầu V	Cầu V
di sản hỗn hợp	di sản hỗn hợp
Bà Nà Hills	Bà Nà Hills
hang động tự nhiên	hang động tự nhiên
Cánh đồng chè	Cánh đồng chè
Tam Đảo	Tam Đảo
động thiên nhiên lớn	động thiên nhiên lớn
Cao nguyên Đá Đồng Văn	Cao nguyên Đá Đồng Văn
đảo	đảo
đôi bàn tay khổng lồ	đôi bàn tay khổng lồ
hệ sinh thái biển đa dạng	hệ sinh thái biển đa dạng
b	b
bãi biển Trần Phú	bãi biển Trần Phú
văn hóa	văn hóa
nhà tù Phú Quốc	nhà tù Phú Quốc
thác Dải Yếm	thác Dải Yếm
khí	khí
hang Sửng Sốt	hang Sửng Sốt
viện Hải dương học	viện Hải dương học
cảnh quan ngoạn mục	cảnh quan ngoạn mục
lăng tẩm	lăng tẩm
cột cờ Lũng Cú	cột cờ Lũng Cú
Cầu Vàng bàn tay khổng lồ	Cầu Vàng bàn tay khổng lồ
nhà hát Lớn	nhà hát Lớn
Quần thể danh thắng Tràng An	Quần thể danh thắng Tràng An
ch	ch
Cát Bà	Cát Bà
Dinh Cậu	Dinh Cậu
bãi biển cát trắng	bãi biển cát trắng
cồn Phụng	cồn Phụng
bãi biển xanh	bãi biển xanh
non nước	non nước
nước mắm	nước mắm
Đầm Vân Long	Đầm Vân Long
đèo Mã Pí Lè	đèo Mã Pí Lè
cầu kính Bạch Long	cầu kính Bạch Long
Rùa biển Côn Đảo	Rùa biển Côn Đảo
công viên Sun World	công viên Sun World
đồi cát đỏ hùng vĩ	đồi cát đỏ hùng vĩ
kiến trúc	kiến trúc
lăng tẩm các vua Nguyễn	lăng tẩm các vua Nguyễn
khu dự trữ sinh quyển	khu dự trữ sinh quyển
Mũi C	Mũi C
văn hóa chợ sông	văn hóa chợ sông
lễ hội áo dài	lễ hội áo dài
hang động nước ngầm	hang động nước ngầm
biển	biển
quần	quần
cung điện	cung điện
lăng Khải Định	lăng Khải Định
Vinpearl	Vinpearl
Kinh Thành	Kinh Thành
rạn san hô nguyên sinh	rạn san hô nguyên sinh
cánh đồng hoa hướng dương	cánh đồng hoa hướng dương
cây cầu Vàng	cây cầu Vàng
kiến trúc cổ điển	kiến trúc cổ điển
Nhà tù Côn Đảo	Nhà tù Côn Đảo
bãi Cháy	bãi Cháy
Cầu Vàng	Cầu Vàng
hòn ngọc biển Đông	hòn ngọc biển Đông
động Thiên Đường	động Thiên Đường
bãi Sao	bãi Sao
làng chài Hàm Ninh	làng chài Hàm Ninh
hang nước ngầm Việt Nam	hang nước ngầm Việt Nam
cây cầu Vàng nổi bật	cây cầu Vàng nổi bật
hoa mận đầu xuân	hoa mận đầu xuân
hồ Hoàn Kiếm	hồ Hoàn Kiếm
lễ	lễ
cồn cát đỏ	cồn cát đỏ
cung đình và lăng tẩm	cung đình và lăng tẩm
Bãi Dài	Bãi Dài
Vũng Tàu	Vũng Tàu
tháp thờ nữ thần Ponagar	tháp thờ nữ thần Ponagar
bến Ninh Kiều	bến Ninh Kiều
vườn hoa thành phố	vườn hoa thành phố
Lễ hội pháo hoa	Lễ hội pháo hoa
thác Bạc Tam Đảo	thác Bạc Tam Đảo
Lăng Chủ tịch Hồ Chí Minh	Lăng Chủ tịch Hồ Chí Minh
Thung lũng tình yêu	Thung lũng tình yêu
biển Nhật Lệ	biển Nhật Lệ
Bắc Hà	Bắc Hà
xanh	xanh
hệ thống hang động dài nhất	hệ thống hang động dài nhất
thung lũng tình yêu	thung lũng tình yêu
Cao Nguyên Đắk Lắk	Cao Nguyên Đắk Lắk
Sa Pa	Sa Pa
Vịnh biển	Vịnh biển
chợ Đông Ba	chợ Đông Ba
Mỹ Sơn	Mỹ Sơn
Tràng An và Tam Cốc	Tràng An và Tam Cốc
khí hậu ôn đới quanh năm	khí hậu ôn đới quanh năm
quần thể danh thắng	quần thể danh thắng
kiến trúc cổ kính và đèn lồng	kiến trúc cổ kính và đèn lồng
vinpearl Land	vinpearl Land
khu dự trữ sinh quyển thế giới	khu dự trữ sinh quyển thế giới
Rừng thông	Rừng thông
Vịnh Hạ Long	Vịnh Hạ Long
Con Đảo	Con Đảo
ruộng bậc thang lúa chín	ruộng bậc thang lúa chín
di tích	di tích
cáp treo dài nhất thế giới	cáp treo dài nhất thế giới
tháp Chăm	tháp Chăm
di tích lịch sử	di tích lịch sử
di sản cố đô	di sản cố đô
hệ thống hang động kỳ vĩ	hệ thống hang động kỳ vĩ
vịnh	vịnh
thánh địa	thánh địa
phố cổ và kiến trúc truyền thống	phố cổ và kiến trúc truyền thống
Vịnh	Vịnh
thiên nhiên	thiên nhiên
vịnh Hạ Long được UNESCO công nhận	vịnh Hạ Long được UNESCO công nhận
cảnh quan huyền bí dưới lòng đất	cảnh quan huyền bí dưới lòng đất
ruộng bậc thang và dân tộc thiểu số	ruộng bậc thang và dân tộc thiểu số
hàng ngàn đảo đá vôi	hàng ngàn đảo đá vôi
Mũi đất cực Nam	Mũi đất cực Nam
cảnh quan Tràng An	cảnh quan Tràng An
“Hạ Long trên cạn”	“Hạ Long trên cạn”
du thuyền trên vịnh	du thuyền trên vịnh
Hồ Hoàn Kiếm	Hồ Hoàn Kiếm
đèo Mã Pí Lèng	đèo Mã Pí Lèng
Cầu Rồng	Cầu Rồng
cố đô Hoa Lư	cố đô Hoa Lư
động Phong Nha	động Phong Nha
kiến trúc cổ kính	kiến trúc cổ kính
Cao nguyên đá	Cao nguyên đá
hang động lớn	hang động lớn
khu phố cổ lịch sử	khu phố cổ lịch sử
thác Bản	thác Bản
Đảo ngọc	Đảo ngọc
thánh địa Chăm Pa	thánh địa Chăm Pa
Đồi cát Mũi Né	Đồi cát Mũi Né
di sản cung đình	di sản cung đình
núi	núi
cung điện Nguyễn triều	cung điện Nguyễn triều
Kon Tum	Kon Tum
chùa Linh Ứng	chùa Linh Ứng
Ruộng	Ruộng
