Di sản thiên nhiên thế giới	Di sản thiên nhiên thế giới
Di sản thế giới	Di sản thế giới
Di sản văn hóa thế giới	Di sản văn hóa thế giới
Khí hậu	Khí hậu
Nơi ngắm lúa chín	Nơi ngắm lúa chín
Quan_he	Quan_he
Tràng An	Tràng An
bao gồm	bao gồm
biết đến	biết đến
biết đến với	biết đến với
biển	biển
biển xanh	biển xanh
biểu tượng	biểu tượng
biểu tượng của	biểu tượng của
biệt danh	biệt danh
bãi biển	bãi biển
bảo tồn	bảo tồn
cao nguyên đá	cao nguyên đá
chiến thắng lịch sử	chiến thắng lịch sử
chợ	chợ
chứa	chứa
chứa đựng	chứa đựng
cáp treo	cáp treo
cáp treo đạt kỷ lục Guinness	cáp treo đạt kỷ lục Guinness
cây cầu nổi tiếng	cây cầu nổi tiếng
còn gọi là	còn gọi là
có	có
có cầu	có cầu
có thác	có thác
có đặc trưng là	có đặc trưng là
có địa điểm	có địa điểm
công viên địa chất	công viên địa chất
cảnh quan	cảnh quan
cầu Rồng	cầu Rồng
cầu biểu tượng	cầu biểu tượng
cố đô	cố đô
cố đô lịch sử	cố đô lịch sử
cổ kính	cổ kính
cổ kính với	cổ kính với
cực Nam	cực Nam
danh thắng	danh thắng
danh tiếng	danh tiếng
di chỉ khảo cổ	di chỉ khảo cổ
di sản	di sản
di sản UNESCO	di sản UNESCO
di sản thiên nhiên	di sản thiên nhiên
di sản thiên nhiên thế giới	di sản thiên nhiên thế giới
di sản thế giới	di sản thế giới
di sản thế giới dự kiến	di sản thế giới dự kiến
di sản văn hóa	di sản văn hóa
di sản văn hóa thế giới	di sản văn hóa thế giới
du lịch	du lịch
duy nhất	duy nhất
duy trì	duy trì
dài nhất	dài nhất
ghi danh	ghi danh
ghi dấu	ghi dấu
giữ	giữ
giữ gìn	giữ gìn
gây ấn tượng bởi	gây ấn tượng bởi
gây ấn tượng với	gây ấn tượng với
gìn giữ	gìn giữ
gắn liền	gắn liền
gắn liền với	gắn liền với
gọi tên	gọi tên
hang động lớn nhất	hang động lớn nhất
hình thành từ nham thạch	hình thành từ nham thạch
hòn đảo	hòn đảo
hòn đảo du lịch	hòn đảo du lịch
hùng vĩ	hùng vĩ
hùng vĩ tại	hùng vĩ tại
hút khách	hút khách
hấp dẫn	hấp dẫn
hấp dẫn bởi	hấp dẫn bởi
hấp dẫn du khách với	hấp dẫn du khách với
hấp dẫn với	hấp dẫn với
hồ đẹp	hồ đẹp
khu dự trữ	khu dự trữ
khu dự trữ sinh quyển	khu dự trữ sinh quyển
khám phá	khám phá
khí hậu	khí hậu
khí hậu mát mẻ	khí hậu mát mẻ
kinh đô cũ	kinh đô cũ
kiến trúc	kiến trúc
kiến trúc Chăm	kiến trúc Chăm
kiến trúc cổ	kiến trúc cổ
kỳ quan	kỳ quan
kỳ quan thiên nhiên	kỳ quan thiên nhiên
kỳ thú	kỳ thú
kỳ vĩ	kỳ vĩ
kỳ ảo	kỳ ảo
linh thiêng	linh thiêng
là	là
là biểu tượng của	là biểu tượng của
là nơi có	là nơi có
là nơi nổi bật với	là nơi nổi bật với
là vườn quốc gia đầu tiên	là vườn quốc gia đầu tiên
làng bản	làng bản
lãng mạn	lãng mạn
lôi cuốn với	lôi cuốn với
lưu giữ	lưu giữ
lịch sử	lịch sử
lớn nhất	lớn nhất
lớn nhất Việt Nam	lớn nhất Việt Nam
mang dấu ấn với	mang dấu ấn với
mơ mộng	mơ mộng
mệnh danh	mệnh danh
mộng mơ	mộng mơ
nhà tù	nhà tù
núi	núi
núi non	núi non
nơi có	nơi có
nằm trong	nằm trong
nằm ở	nằm ở
nổi bật	nổi bật
nổi bật bởi	nổi bật bởi
nổi bật về	nổi bật về
nổi bật với	nổi bật với
nổi danh	nổi danh
nổi danh với	nổi danh với
nổi tiếng	nổi tiếng
nổi tiếng bởi	nổi tiếng bởi
nổi tiếng về	nổi tiếng về
nổi tiếng với	nổi tiếng với
phim trường	phim trường
phát triển	phát triển
phố cổ	phố cổ
phố cổ UNESCO	phố cổ UNESCO
quay phim	quay phim
quyến rũ	quyến rũ
ruộng bậc thang	ruộng bậc thang
rực rỡ với	rực rỡ với
sôi động	sôi động
sôi động với	sôi động với
sản xuất	sản xuất
sở hữu	sở hữu
thiên đường	thiên đường
thiên đường biển đảo	thiên đường biển đảo
thiên đường của	thiên đường của
thu hút	thu hút
thu hút bởi	thu hút bởi
thu hút du khách	thu hút du khách
thu hút du khách bởi	thu hút du khách bởi
thu hút khách bởi	thu hút khách bởi
thu hút khách du lịch	thu hút khách du lịch
thu hút với	thu hút với
thuộc	thuộc
thuộc hệ thống	thuộc hệ thống
thuộc về	thuộc về
thành phố	thành phố
thành phố biển	thành phố biển
thành phố ngàn hoa	thành phố ngàn hoa
thơ mộng	thơ mộng
thắng cảnh	thắng cảnh
thủ đô	thủ đô
thủ đô Việt Nam	thủ đô Việt Nam
tiểu sa mạc	tiểu sa mạc
trung tâm	trung tâm
trung tâm lặn biển	trung tâm lặn biển
truyền thống	truyền thống
trải nghiệm	trải nghiệm
trồng	trồng
tuyệt đẹp	tuyệt đẹp
tổ chức	tổ chức
tổ chức sự kiện	tổ chức sự kiện
tự hào	tự hào
tự hào với	tự hào với
ví như	ví như
ví von	ví von
văn hóa sông nước	văn hóa sông nước
vịnh kín tuyệt đẹp	vịnh kín tuyệt đẹp
Địa điểm du lịch nổi tiếng	Địa điểm du lịch nổi tiếng
đa dạng sinh học	đa dạng sinh học
điểm du lịch	điểm du lịch
điểm du lịch nổi tiếng	điểm du lịch nổi tiếng
điểm đến	điểm đến
điểm đến nghỉ dưỡng	điểm đến nghỉ dưỡng
đã từng là	đã từng là
được UNESCO công nhận	được UNESCO công nhận
được UNESCO công nhận là	được UNESCO công nhận là
được biết đến	được biết đến
được biết đến là	được biết đến là
được biết đến như	được biết đến như
được biết đến với	được biết đến với
được công nhận	được công nhận
được công nhận là	được công nhận là
được gọi	được gọi
được gọi là	được gọi là
được mệnh danh	được mệnh danh
được mệnh danh là	được mệnh danh là
đảo	đảo
đảo du lịch	đảo du lịch
đảo ngọc	đảo ngọc
đặc biệt	đặc biệt
đặc sản	đặc sản
đặc sắc	đặc sắc
đặc sắc với	đặc sắc với
đặc trưng	đặc trưng
đặc trưng bởi	đặc trưng bởi
đặc trưng với	đặc trưng với
đẹp	đẹp
địa danh	địa danh
địa điểm của	địa điểm của
địa điểm du lịch	địa điểm du lịch
định vị	định vị
độc đáo	độc đáo
độc đáo với	độc đáo với
ấn tượng	ấn tượng
ấn tượng với	ấn tượng với
ẩm thực	ẩm thực
ẩm thực đặc trưng	ẩm thực đặc trưng
